hotelsoftware	[]
router/switch	[]
pferde	[src\main\resources\extractedWiki\BV/wiki_98	jäger-regiment zu pferde nr. 9]
elektromeise	[]
cms-umfeld	[]
netphone	[]
transportfahrzeug	[]
dns?	[]
betriebsdatenerfassungssystem beosys	[]
omnibusse	[]
cdb	[]
traktoren/schlepper	[]
feststoffkessel	[]
leuchtlupe	[]
verpackungsmaschine	[]
windowsmobile	[]
kühler/plane	[]
lean-tools	[]
omniorb	[]
microsoft-office-programmen	[src\main\resources\extractedWiki\CJ/wiki_99	liste der öffentlich-rechtlichen hd-programme in europa]
sps-simatic	[]
ug-nx	[]
anhänger/wechselbrückenzug	[]
microstation v 8.5/xm/j	[src\main\resources\extractedWiki\BT/wiki_99	john v. tunney]
siemens/haidenhein	[]
verdichtungsgerät	[]
flurfahrzeuge	[]
windchill/	[]
turbomaschine	[]
seitenschneider	[]
,exel	[]
mssql	[]
cfd	[]
sps(s5/s7	[]
lader	[]
pro/w wildfire 4	[src\main\resources\extractedWiki\BV/wiki_98	chromosom 4 (mensch)]
generator/umrichter	[]
bauplan	[]
s7/pcs7	[src\main\resources\extractedWiki\AT/wiki_99	saleen s7]
windows-/	[src\main\resources\extractedWiki\BT/wiki_96	windows developer]
modbus	[]
rundtaktautomat	[]
datenbanksystem	[]
webcontrolling-tool	[]
wikis	[]
sps steuerung	[]
absturzsicherung	[]
imds	[]
agiesteuerung	[]
telekommunikationsgerät	[]
schweißgerat	[]
hochregalbediengerät	[]
elektromanager	[]
folgewerkzeug	[]
planungssoftware	[]
sql-server	[]
edge-cam	[]
sap-basis-anwendung	[]
profi-bus	[src\main\resources\extractedWiki\CJ/wiki_99	de haan’s bus &amp; coach]
lotus notes	[src\main\resources\extractedWiki\CN/wiki_55	carl lotus becker]
ms/ms	[]
konstruktionsplan	[]
objective-c	[]
straßenwalz	[]
karusselldrehautomat	[]
flachwaggon	[]
montageautomat	[]
gehaltsprogramm	[]
grafikprogramm	[]
ajax-framework	[]
abkantpresse	[]
jetty	[]
sapv	[]
fließplan	[]
produktionsmaschinen	[]
produktserver	[]
atemschutz	[]
powerdesigner	[]
standard-softwareprodukt	[src\main\resources\extractedWiki\BT/wiki_96	nash standard eight]
router/modem/wlan	[src\main\resources\extractedWiki\AM/wiki_00	lolita-mode]
erp-programm	[src\main\resources\extractedWiki\CJ/wiki_99	liste der öffentlich-rechtlichen hd-programme in europa]
spritzpistole	[]
cnc-bohrer	[]
verdingungsordnung	[]
handbuch	[]
outlook	[]
illustrator	[]
vm-ware	[src\main\resources\extractedWiki\CJ/wiki_99	the war at home (1996)]
atlas	[]
frontrange	[]
corel	[]
optische messmittel	[]
cad-tools	[]
actionscript	[]
roro	[]
java-bibliothek	[src\main\resources\extractedWiki\CN/wiki_55	bibliothek des hauses usher]
elektro-cad-system	[src\main\resources\extractedWiki\BV/wiki_98	politisches system indiens]
presse	[]
rhinoceros	[]
handelsrecht	[]
winsolvenz	[]
clientbetriebssystem	[]
microcomputer	[]
sinumerik	[]
gis-anwendung	[]
blechbearbeitungsmaschine	[]
messanlage	[]
caq-system	[src\main\resources\extractedWiki\BV/wiki_98	politisches system indiens]
acd-netzwerken	[]
sinumeric	[]
macintosh	[]
punktschweiß-schablon	[]
proalpha	[]
office-software	[src\main\resources\extractedWiki\AM/wiki_02	business software alliance]
sicherheitsanweisung	[]
staubsauger	[]
druckmessgerät	[]
mssql/mysql	[]
regelwerk	[]
sap®	[]
kleinkran	[]
bilanzierungsnorm	[]
3d-cad-system	[src\main\resources\extractedWiki\BV/wiki_98	politisches system indiens]
ms office-paket	[]
sprechanlage	[]
cms	[]
tandemhängerzug	[]
linux-distribution	[]
kassenprogramm	[]
caterpillar	[]
plasmaschneider	[]
ccia	[]
cnc	[]
umformer	[]
servicefahrzeug	[]
os/400	[src\main\resources\extractedWiki\BT/wiki_96	nash 400]
zweirad	[]
kassenpreislist	[]
2d-grafik-software	[src\main\resources\extractedWiki\AM/wiki_02	business software alliance]
speedikon	[]
kranfahrzeuge	[]
handhabungsautomat	[]
jugendschutz	[]
operationsinstrument	[]
quad	[]
tiefbaufahrzeug	[]
struts2	[]
software-versionsverwaltungssystem	[src\main\resources\extractedWiki\AM/wiki_02	business software alliance]
beschichtungs-/rtp-anlage	[]
eclips rcp	[]
robotersteuerung	[]
xenserver	[]
zuggerät	[]
standard-office-anwendung	[src\main\resources\extractedWiki\BT/wiki_96	nash standard eight]
rohrbiegemaschine	[]
verstärker	[]
xp/2003/vista/2008	[src\main\resources\extractedWiki\BT/wiki_97	dfb-hallenpokal der frauen 2008]
ls-dyna	[]
3-achser	[]
word/pdf-dokument	[]
crimpzangen	[]
spindelwerkzeug	[]
ms-betriebssystem	[]
sas-software	[src\main\resources\extractedWiki\AM/wiki_02	business software alliance]
lan	[]
hänger	[]
audacitiy	[]
freischneider	[]
hibernate/spring/strut	[]
fanuc-standard	[src\main\resources\extractedWiki\BT/wiki_96	nash standard eight]
2d/3d	[]
cronjobs	[]
flurföderfahrzeug	[]
stanzwerkzeug	[]
lieferpapier	[]
schweißautomat	[]
dichtheitsprüfanlage	[]
applus	[]
hebewerkzeug	[]
inca.	[]
pc/sc	[src\main\resources\extractedWiki\CN/wiki_55	sc friedrichsthal]
warenwirtschaftsprogramm	[]
ansys-workbench	[]
nutfräse	[]
corel draw	[]
jquery/prototype	[]
sps-steuerungen/automatisierungstechnik	[]
groupwaresystem	[]
word/pdf	[]
basic/.net	[]
scripting	[]
verkehrsanlage	[]
jumbozug	[]
dtp-applikation	[]
ra-micro	[]
pro/engineer®	[]
steuerrecht	[]
.net3	[]
crm	[]
roboter-programme	[src\main\resources\extractedWiki\CJ/wiki_99	liste der öffentlich-rechtlichen hd-programme in europa]
my sql	[src\main\resources\extractedWiki\BT/wiki_98	monster in my pocket]
mb-baustatik-programmen	[src\main\resources\extractedWiki\CJ/wiki_99	liste der öffentlich-rechtlichen hd-programme in europa]
ladekrane-behälterwechselsystem	[]
entgratungswerkzeuge	[]
qualitätsnorm	[]
digitalkamera	[]
pacs-programm	[src\main\resources\extractedWiki\CJ/wiki_99	liste der öffentlich-rechtlichen hd-programme in europa]
kipperverkehr-2-achser	[]
wäschereimaschine	[]
wasserrecht	[]
css	[src\main\resources\extractedWiki\BV/wiki_99	css-9]
gießmaschine	[]
brenngerät	[]
ansys	[]
tankwagen	[]
filemaker	[]
satzprogramm	[]
crimpzang	[]
türsprechanlage	[]
pacs	[]
bmsr-anlage	[]
skr04	[]
wechselbrückenfahrzeug	[]
sozialgesetzgebung	[]
clist	[]
kaffeemaschine	[]
office-anwendung	[]
as/400	[src\main\resources\extractedWiki\BT/wiki_96	nash 400]
vmware	[]
2d-laserschneidanlagen	[]
monitore	[]
mfgpro	[]
abrollmaschine	[]
msdynamic	[]
reflowof	[]
disto	[]
umweltnorm	[]
doppelstockameise	[]
simulink	[]
sammelhefter	[]
dgr pk7	[]
exchange-server	[]
audatex	[]
unix/linux-system	[src\main\resources\extractedWiki\BV/wiki_98	politisches system indiens]
ordnungsrecht	[]
lkw¿s	[]
kleinbagger	[]
abap-programmierung	[]
eplan5	[]
logocad	[]
backofficesystem	[]
reinigungswerkzeug	[]
gliederfahrzeug	[]
bs 7799	[]
richtpresse	[]
cornerstone	[]
photo shop	[]
u-bahnen	[src\main\resources\extractedWiki\AT/wiki_99	leuk-leukerbad-bahn]
einrichtungssoftware	[]
crm-systeme	[]
brotschneidemaschine	[]
magnesiumpresse	[]
pc's	[]
pecm-maschine	[]
eu-recht	[src\main\resources\extractedWiki\CN/wiki_53	eu-zivilschutz-mechanismus, src\main\resources\extractedWiki\AA/wiki_00	abkürzungen/gesetze und recht]
l2tp	[]
verdrahtungsplan	[]
rettungswagen	[]
handwerkzeuge	[]
cnc-pressmaschine	[]
arbschg	[]
i-deas	[]
qm-norm	[src\main\resources\extractedWiki\AT/wiki_98	europäische norm]
stanzbiegeautomat	[]
xml/xslt/xsl	[]
e-ameise	[]
applikationsserver	[]
cxf	[]
adword	[]
buchungsprogramm	[]
pdm system	[src\main\resources\extractedWiki\BV/wiki_98	politisches system indiens]
suite8	[]
pc-betriebssystem	[]
standardmessmittel	[]
zuwendungsrecht	[]
thin-client	[]
hubwagen/ameise	[]
sortiergerät	[]
solaranllage	[]
handscanner	[]
schneidbrenner	[]
schmalgangstapler	[]
stampfer	[]
seitenschubmast	[]
ncts	[]
win2005	[]
win2000	[]
cnc-mehrspindeldrehautomat	[]
hicad	[]
turmdrehkräne	[]
mibg	[]
testanweisung	[]
java/c++	[]
lkw	[]
abbruchbagger	[]
hubgerüst	[]
airmixpumpe	[]
seitenschub-gabelstapler	[]
diktiersystem	[]
abfallgesetz	[]
dokumenten-management-system	[src\main\resources\extractedWiki\BV/wiki_98	politisches system indiens]
apacheserver	[]
c#/asp.net	[]
isa-server	[]
videoüberwachungsanlage	[]
müllfahrzeug	[]
solid-edge	[]
leicht-lkw	[]
computertomograph	[]
x-haus	[src\main\resources\extractedWiki\AM/wiki_01	haus knippenburg]
funk	[]
client-serverbetriebssystemen	[]
tafelstanzautomat	[]
plc/sps	[]
palm	[src\main\resources\extractedWiki\CJ/wiki_98	henry robinson palmer]
petrischale	[]
maschnine	[]
wendeschneidplatte	[]
ms-ofice	[]
personalcomputer	[]
sattel-/hängerzug	[]
ansa	[]
rohrprofilieranlage	[]
plasma-autogenschneidanlage	[]
gefahrgutrecht	[]
datev	[]
tarifrecht	[]
installationszeichnung	[]
bash/ksh	[]
energieübertragungsanlage	[]
addison	[]
omnibussen	[]
kippsattelauflieger	[]
ex-cel	[src\main\resources\extractedWiki\CJ/wiki_98	arthur celeste]
cad-nemetschek	[]
kochkessel	[]
erms	[]
centos	[]
dojo	[]
wäschetrockner	[]
kfz-fahrzeug	[src\main\resources\extractedWiki\BV/wiki_98	kfz-kennzeichen (philippinen)]
diensttelefon	[]
qs/qm	[]
lok	[]
mobilkran	[]
computer	[src\main\resources\extractedWiki\AA/wiki_00	liste von abkürzungen (computer)]
s5/s7	[src\main\resources\extractedWiki\AT/wiki_99	saleen s7]
iptv-gerät	[]
immobilienmanagement-software	[src\main\resources\extractedWiki\AM/wiki_02	business software alliance]
ooa/ood	[]
ladewagen	[]
html/xhtml	[]
entnahmeroboter	[]
proe	[]
durchlaufmaschine	[]
speedport	[]
canalyzer	[]
telekommunkationsanlage	[]
firewall	[]
db2	[]
anhänger	[]
prozessplan	[]
datenbankapplikation	[]
redaktionsprogramm	[]
deckenkran	[]
versionsverwaltungssystem	[]
sabre	[]
waldbearbeitungsmaschine	[]
medusa	[]
diagnosegerät	[]
betriebsverfassungsgesetz	[]
solution manager	[src\main\resources\extractedWiki\BV/wiki_99	purchasing managers index]
sportflugzeug	[]
unix/windows	[src\main\resources\extractedWiki\BT/wiki_96	windows developer]
adr/rid	[]
ucc	[]
stanzautomat	[]
dat	[]
autocad-adt	[]
kantenanleimmaschine	[]
längenprüfmittel	[]
ejbs	[]
abrollfahrzeug	[]
linux-betriebssystem	[]
flugobjekt	[]
mysql¿flash	[]
adobe-programm	[src\main\resources\extractedWiki\CJ/wiki_99	liste der öffentlich-rechtlichen hd-programme in europa]
entnahmegera¿t	[]
spektrometer	[]
langgabelstapler	[]
hyperwork	[]
cnc-abkantbänken	[]
computertomografe	[]
transferanlage	[]
photoshop mac	[src\main\resources\extractedWiki\BV/wiki_97	mac-50]
step-7	[]
irisplus	[]
nutzfahzeuge	[]
elektroschaltplan	[]
pinsel	[]
heidenhain-maschine	[]
backenstapler	[]
abscheideranlage	[]
schwingungsmesssystem	[]
mobilbagger/minibagger	[]
webmaschine	[]
cad-system	[src\main\resources\extractedWiki\BV/wiki_98	politisches system indiens]
sap/hrp	[]
voicexml	[]
holzkreissag	[]
recyclinganlage	[]
funkmietwagen	[]
ethernet-netzwerk	[]
lagersoftware	[]
browser	[]
oprofessional planner	[]
mathematica	[]
luxusbus	[]
heizungsanlage	[]
falzaggregat	[]
buchhaltungssystem	[]
containerfahrzeug	[]
schema st4	[]
dienst-pkw	[src\main\resources\extractedWiki\AT/wiki_98	dienst (telekommunikation)]
radlader-bagger	[]
schalplan	[]
sozialrecht	[]
materialwirtschaftsprogramm	[]
ddl	[]
spritzgußmaschine	[]
power-point	[src\main\resources\extractedWiki\BT/wiki_95	stony point (north carolina)]
dataguard	[]
schaufel	[]
lua	[]
office-programm	[src\main\resources\extractedWiki\CJ/wiki_99	liste der öffentlich-rechtlichen hd-programme in europa]
rührwerk	[]
servlet	[]
sap-programm	[src\main\resources\extractedWiki\CJ/wiki_99	liste der öffentlich-rechtlichen hd-programme in europa]
küchenplanungssystem	[]
scanner	[]
datenbankmanagementsystem	[]
kippsattel	[]
eu-richtlinie	[src\main\resources\extractedWiki\CN/wiki_53	eu-zivilschutz-mechanismus]
standard-bürosoftware	[src\main\resources\extractedWiki\BT/wiki_96	nash standard eight]
lebensmittelgesetz	[]
muldenkipper	[]
lötkolbe	[]
skiptsprache	[]
umformautomat	[]
beatmungsmaschine	[]
sägeeinheit	[]
drehbänke	[]
lvs	[]
containerwagen	[]
ws-cad	[]
bedienpulte	[]
blechverarbeitungsmaschine	[]
patran	[]
din-programm	[src\main\resources\extractedWiki\CJ/wiki_99	liste der öffentlich-rechtlichen hd-programme in europa]
digitizer	[]
3d-cad-konstruktion	[]
ms-web-technologie	[src\main\resources\extractedWiki\CN/wiki_53	franz-weber-hof]
normenwesen	[]
microsoft exchang server	[]
c#.net	[]
uhr	[]
kippsattelzug	[]
cnc-schweißautomat	[]
lagertransportmittel	[]
gaslötbrenner	[]
kühlkoffer	[]
rasenmäher	[]
blechbiegewalz	[]
extbase/fluid	[]
backofen	[]
tnc 530	[]
gasstapler	[]
motoroller	[]
e-flurförderzeug	[]
absetzkipper	[]
ajax-technologie	[]
scherenanhänger	[]
datenbank-tools	[]
asp classic	[]
cucm	[]
inca	[]
transporter	[]
showcase	[]
flurf<f6>rder-zeug	[]
kühlsattelzug	[]
baan	[]
nc-programm	[src\main\resources\extractedWiki\CJ/wiki_99	liste der öffentlich-rechtlichen hd-programme in europa]
spritzmaschine	[]
tk-anlage	[]
freehand	[]
4-achser	[]
ms-server	[]
nc-schleifmaschine	[]
sortiergreifer	[]
digitalkopierer	[]
diagnose-software	[src\main\resources\extractedWiki\AM/wiki_02	business software alliance]
barcodelaser	[]
mehrfachstapler	[]
access control	[src\main\resources\extractedWiki\BV/wiki_97	control-l]
hibernat	[]
plpgsql	[]
druckluftanlage	[]
tragwagen	[]
datev/kanzlei	[]
mysql<u+00bf>flash	[]
serverlandschaft	[]
abrollmuld	[]
ethernet	[]
bgb-bestimmung	[]
bedienungsanleitung	[]
drupal	[]
fahrzeugtransporter	[]
baugerat	[]
detektor	[]
kunststoffspritzanlage	[]
therapiesimulator	[]
pocket-pc's	[src\main\resources\extractedWiki\BT/wiki_98	monster in my pocket]
telekommunikationstechnik	[]
gefahrenmeldeanlage	[]
uml	[]
fortran	[]
kühltransporter	[]
file-server	[]
kanalspülfahrzeug	[]
längenmeßmittel	[]
rplan	[]
datev/fibu	[]
faxgerät	[]
verfahrensanweisung	[]
rohbauschweißanlage	[]
meßmikroskop	[]
blackberry	[]
extend presse	[]
cadison	[]
extrusionsanlage	[]
navigation	[]
lodas	[]
db2-datenbank	[]
kommissionier-gerät	[]
zerspane	[]
fanuk	[]
printer	[]
bitv	[]
dns	[]
gabelstapler/radlader	[]
fanuc	[]
java-patter	[]
twin-cat	[]
mathlab-simulink	[]
mssql-datenbank	[]
grabenverdichter	[]
autotransporter	[]
schubmastgerät	[]
server	[]
baumschine	[]
sps/s7-programmierung	[src\main\resources\extractedWiki\AT/wiki_99	saleen s7]
inventor/autocad	[]
pressautomat	[]
:sattelzug	[]
prime a350	[]
dos	[src\main\resources\extractedWiki\BT/wiki_99	vicente dos reis]
telefonapparat	[]
q-management	[]
addsion	[]
labor-informations-management-system	[src\main\resources\extractedWiki\BV/wiki_98	politisches system indiens, src\main\resources\extractedWiki\AA/wiki_01	american standard code for information interchange]
orcad	[]
notes/domino	[]
frachtschiff	[]
vlan	[]
laborroboter	[]
.net framework	[]
werkzeugmaschin	[]
unigraphics	[]
programmiersprachen/-technik	[src\main\resources\extractedWiki\AT/wiki_97	bauteil (technik), src\main\resources\extractedWiki\AM/wiki_02	limbo (programmiersprache)]
anhäger	[]
projekmanagement-tool	[]
rhel	[]
planierraup	[]
betriebsfahrzeug	[]
steuerpult	[]
fooke	[]
hand-scann	[src\main\resources\extractedWiki\BV/wiki_99	white hand gang]
hausverwaltungsprogramm	[]
silofahrzeuge	[]
gerätesicherheitsgesetz	[]
sap basis	[]
verpackungsanweisung	[]
patientenverwaltungsprogramm	[]
lkw*****	[]
gentoo	[]
opera	[]
mail	[]
vb.net	[]
hofladern	[]
eisenbahnwagon	[]
pscd	[]
blmschg	[]
tischfräse	[]
unix-derivat	[]
amwhv	[]
pivot-tabelle	[]
xp/vista	[]
linux-system	[src\main\resources\extractedWiki\BV/wiki_98	politisches system indiens]
kipper-fahrzeug	[]
narkosegerät	[]
pneubagger	[]
front/seiten-stapler	[]
nginx	[]
visualbasic	[]
joomla	[]
webgui	[]
ideas	[]
bahn	[src\main\resources\extractedWiki\AT/wiki_99	leuk-leukerbad-bahn]
montageplan	[]
loga	[]
motorsag	[]
excel-dokument	[]
standard-ms-office-anwendung	[src\main\resources\extractedWiki\BT/wiki_96	nash standard eight]
zulassungswesen	[]
siemens-840	[]
sw-tools	[]
lsdyna	[]
gesetzestext	[]
ir-schweißanlage	[]
walzasphaltfertiger	[]
windenergieanlage	[]
feuerungsautomat	[]
rundschleifmaschine	[]
datev-lodas-programm	[src\main\resources\extractedWiki\CJ/wiki_99	liste der öffentlich-rechtlichen hd-programme in europa]
dtd	[]
3d-inventor	[]
rfid-reader	[]
soficad	[]
betriebssysstem	[]
allplan	[]
worknc	[]
formmaschine	[]
oszilloskop	[]
wechselkoffersystem	[]
zeichenprogramm	[]
rohrsäge	[]
langgabel	[]
hydraulikplan	[]
netzwerkdrucker	[]
telefax	[]
schrottschere	[]
start/amadeus/merlin	[]
semantic web	[src\main\resources\extractedWiki\CN/wiki_53	franz-weber-hof]
kanzleisoftware	[]
sketchup	[]
seecontainer	[]
feil	[]
umschlagbagger	[]
ohmmeter	[]
fräsmachine	[]
e-commerce-system	[src\main\resources\extractedWiki\BV/wiki_98	politisches system indiens]
abfüllautomat	[]
umweltrecht	[]
quarkxpress	[]
java-script	[]
lkw-ladearm	[]
db-server	[]
sap-anwendung	[]
messschieb	[]
zollsoftwaresystem	[]
mikrofon	[]
hammerlötkolben	[]
postgressql	[]
hebebühn	[]
fräsroboter	[]
spritzgießwerkzeuge	[]
werksnormblatt	[]
vob/b	[]
vob/c	[]
universalfräsmaschine	[]
dwh	[]
dtp-programm	[src\main\resources\extractedWiki\CJ/wiki_99	liste der öffentlich-rechtlichen hd-programme in europa]
transact-sql	[]
kurbelpresse	[]
windows-betriebssystem	[src\main\resources\extractedWiki\BT/wiki_96	windows developer]
fachsoftware	[]
six sigma	[src\main\resources\extractedWiki\BT/wiki_96	nash big six]
rs232	[]
portalfräsmaschine	[]
materialwirtschaftssystem	[]
mis	[]
internetprogramm	[]
schutzgasschweißgerät	[]
c-sharp	[]
triebwagen	[]
¿outlook	[]
fügemaschine	[]
leiterplatten-layout-system	[src\main\resources\extractedWiki\BV/wiki_98	politisches system indiens, src\main\resources\extractedWiki\BV/wiki_98	layout-engine]
bildbearbeitungs-programmen	[src\main\resources\extractedWiki\CJ/wiki_99	liste der öffentlich-rechtlichen hd-programme in europa]
hs/3-system	[src\main\resources\extractedWiki\BV/wiki_98	politisches system indiens]
aufbauplan	[]
zangen	[]
xaml	[]
c/front	[]
spritzgusswerkzeuge	[]
enterprise architect	[src\main\resources\extractedWiki\CJ/wiki_99	enterprise (oregon)]
konstruktionssoftware	[]
trinotar	[]
exchang server	[]
wordpress	[]
bildbearbeitungsprogramm	[]
project	[]
sattelkipper	[]
bodenschleifmaschine	[]
steuerungshardware	[]
pro_engineer	[]
sccm	[]
3d	[]
biegewerkzeug	[]
datentransfersystem	[]
flurförderzeuge	[]
schneider	[src\main\resources\extractedWiki\CN/wiki_54	reinhard schneider (autor)]
drahtb<fc>rst	[]
mysql	[]
cad-inventor	[]
mülltransporter	[]
programmiergerät	[]
mld	[]
canalyser	[]
5-achs-fräse	[]
mori seiki	[]
sql-anwendung	[]
twincat	[]
schnittwerkzeug	[]
sonderfahrzeug	[]
dxdesigner	[]
internet	[src\main\resources\extractedWiki\AT/wiki_98	rich internet application]
oracle-utilities	[]
¿netbook	[]
cnc-fräsen	[]
handlingsanlage	[]
schankanlage	[]
cnc-fräser	[]
laser-schweißanlage	[]
ganzzug	[]
3d-cad-solidwork	[]
frontend management system	[src\main\resources\extractedWiki\BV/wiki_98	politisches system indiens]
sps simatic s7	[src\main\resources\extractedWiki\AT/wiki_99	saleen s7]
bgb-vertrag	[]
jython	[]
druckgeräterichtlinie	[]
betriebssystema	[]
schalttafel	[]
druckluftpistole	[]
ms-office-applikation	[]
kombidämpfer	[]
simatic s7	[src\main\resources\extractedWiki\AT/wiki_99	saleen s7]
backöfen	[]
cnc-anlage	[]
silofahrzeug	[]
schweißanlage	[]
sap-logistikmodul	[]
abacus	[]
informatica	[]
holzkranzug	[]
sozialversicherungsrecht	[]
windows-server-system	[src\main\resources\extractedWiki\BV/wiki_98	politisches system indiens, src\main\resources\extractedWiki\BT/wiki_96	windows developer]
monit	[]
heller-steuerung	[src\main\resources\extractedWiki\CN/wiki_54	tran und helle]
unigraphix	[]
smd-automat	[src\main\resources\extractedWiki\BT/wiki_95	automatische lautstärkeregelung]
javascript/ajax/jquery	[]
kanalreinigungsfahrzeug	[]
industriesauger	[]
estrichpumpe	[]
kartografiesoftware	[]
kühlschrank	[]
fühler	[]
anhängerzug	[]
verbändevereinbarung	[]
pro-e	[]
badebecken	[]
azure	[]
kaschiermaschine	[]
sprinter	[src\main\resources\extractedWiki\CN/wiki_55	super sprint]
cocreate	[]
cnc-abkantpressen	[]
vda2	[]
spritzgießmaschine	[]
standard-applikationssoftwar	[src\main\resources\extractedWiki\BT/wiki_96	nash standard eight]
arbeits-/hebebühne	[src\main\resources\extractedWiki\AA/wiki_01	arbeit (sozialwissenschaften)]
vba	[]
föne	[]
kunststoffspritzmaschine	[]
microsoft-office-produkt	[]
pipette	[]
dokumentenmanagementsystem	[]
schraubenzieher	[]
word	[]
virtuozzo	[]
nagios	[]
vbs	[]
cad-entwurf	[]
laserschneidemaschine	[]
lkw-anhänger	[]
regalfahrzeug	[]
e-herd	[src\main\resources\extractedWiki\BV/wiki_99	herder-preis]
umformmaschine	[]
zuggeraät	[]
sps-software	[src\main\resources\extractedWiki\AM/wiki_02	business software alliance]
pl-sql	[]
heizkamin	[]
holzbearbeitungsmaschine	[]
nc/sps	[]
hebeanlage	[]
simulink/stateflow	[src\main\resources\extractedWiki\CJ/wiki_99	stateflow]
ms-power	[]
kippfahrzeug	[]
shellscript	[]
mrt	[]
wechselkofferfahrzeuge	[]
geo-informations-system	[src\main\resources\extractedWiki\BV/wiki_98	politisches system indiens, src\main\resources\extractedWiki\AA/wiki_01	american standard code for information interchange]
hochdruckmaschine	[]
tankzug	[]
gebäudetechnisch anlage	[]
e-msr	[]
familienrecht	[]
ecc	[]
hochdruckreiniger	[]
lotus	[src\main\resources\extractedWiki\CN/wiki_55	carl lotus becker]
axis	[]
ms-office(	[]
ecm	[]
embedded-betriebssystemen	[]
kreissäge	[]
html	[]
steigeise	[]
jira	[]
unit-testing	[]
telefonanlagen/	[]
gehgabelhubwagen	[]
fanuc/mitsubishi	[]
sattelauflieger	[]
bauvertragsrecht	[]
haushaltselektrogerät	[]
hubsteiger	[]
cnc-gesteuerte maschine	[]
windows-office	[src\main\resources\extractedWiki\BT/wiki_96	windows developer]
htlm	[]
tablet-pc`	[]
simpack	[]
isodraw	[]
prosteel	[]
holzfertigungsmaschine	[]
3d-cad-systemen	[]
cplds	[]
tabellkalkulationsprogramm	[]
drehbank	[]
zugwaggon	[]
autodesk-produkt	[]
x++	[]
flurförderfahrzeuge	[]
microsoft<u+00ae>	[]
postfix	[]
pro/e	[]
sattelfahrzeug	[]
firewall-l<f6>sung	[]
normschrift	[]
kommunikationsprotokolle	[]
cad-systemen	[]
segelyacht	[]
cape-nt	[]
mysql/sql/oracle	[]
toad	[]
mvs	[]
schraubendreher	[]
typo3-extension	[]
dienstfahrzeug	[]
cnc-stepp	[]
stra<df>enbahn	[]
handpoliermaschine	[]
ant/maven	[]
mikrocontroller	[]
smartphone	[]
fugenschneider	[]
html5	[]
straßenkarte	[]
mailserver	[]
laptop	[]
handy	[]
autodesk-themen	[]
normwerk	[]
siematic	[]
scom	[]
e-mail-server	[]
pcblut	[]
doe-tools	[]
wärmepumpe	[]
sps-technik	[src\main\resources\extractedWiki\AT/wiki_97	bauteil (technik)]
oracle/sql	[]
rechnersystem	[]
hilfswerkzeug	[]
lebensmittelrecht	[]
minibagger	[]
eswl	[]
ms-powerpoint	[]
haushaltsgerät	[]
brennwertanlage	[]
ms-office-programmen	[src\main\resources\extractedWiki\CJ/wiki_99	liste der öffentlich-rechtlichen hd-programme in europa]
vista	[]
abap/oo	[]
widerstandsmessgerät	[]
simulationssystem	[]
rohrvortriebsanlage	[]
dampfstrahler	[]
cnc-fräßer	[]
lötkolben	[]
eventviewer	[]
erp/pps	[]
terminplanungssoftware	[]
schmalspurtraktor	[]
ejb	[]
stromlaufplan	[]
neigungsmesser	[]
vestra	[]
damp-software	[src\main\resources\extractedWiki\AM/wiki_02	business software alliance]
java/j2ee	[]
mobil kran	[]
hp-ux	[]
logicad	[]
heidenhain	[]
d-cad-system	[src\main\resources\extractedWiki\BV/wiki_98	politisches system indiens]
mazarol-steuerung	[]
kabelschaltplan	[]
bildverarbeitungs-kamera	[src\main\resources\extractedWiki\CJ/wiki_98	goldene kamera 1996]
schwachstromanlage	[]
treiberprogrammierung	[]
sql-datenbank-/	[]
millplus	[]
heuwender	[]
prägemaschine	[]
laseranlage	[]
netware	[]
e-mail-client	[]
produktionsautomat	[]
schienenfahrzeug	[]
mobilbagger	[]
contentblue	[]
publishing-programmen	[src\main\resources\extractedWiki\AT/wiki_97	quark publishing system, src\main\resources\extractedWiki\CJ/wiki_99	liste der öffentlich-rechtlichen hd-programme in europa]
ms-exel	[]
client-betriebssystem	[]
jscript	[]
spring	[]
onespace designer modeling	[]
erp/mrp-system	[src\main\resources\extractedWiki\BV/wiki_98	politisches system indiens]
ctx-alph	[]
heizung	[]
gabelstappler	[]
peg-sonde	[]
,montageanleitung	[]
fi-aa	[src\main\resources\extractedWiki\BT/wiki_96	wi-fi protected setup, src\main\resources\extractedWiki\BV/wiki_99	hillebrand van der aa]
mikrosystem	[]
steuerungsprogramm	[]
transact	[]
metallbearbeitungswerkzeug	[]
catalyst	[]
caddatenbank	[]
meßschieber	[]
unix-scripting	[]
tandemanhänger	[]
spritzgerät	[]
virtualisierungssoftware	[]
vob	[]
traub-maschine	[]
rückendrahtheftmaschine	[]
fax-server	[src\main\resources\extractedWiki\CJ/wiki_99	liste der biografien/fax]
lichtrufsystem	[]
gummikettenbagger	[]
grafikprogramme	[]
bimschg	[]
cd-roms	[src\main\resources\extractedWiki\BV/wiki_97	internationale konferenz von rom für die soziale verteidigung gegen anarchisten, src\main\resources\extractedWiki\BV/wiki_98	cd málaga]
vol	[]
pkms	[]
cargoonline	[]
tandemachser	[]
holzbearbeitungsmaschin	[]
c/c++	[]
haidenhain-maschine	[]
sozialgesetzbuch	[]
e-check	[]
werkstückspannsystem	[]
folgeverbundwerkzeuge	[]
dumper	[]
feinmessgerät	[]
lagerverwaltungssoftware	[]
mietvertragswesen	[]
c-programmierung/-library	[]
vpm	[]
vpn	[]
kernbohreinheit	[]
büroartikel	[]
klimaanlage	[]
immissionsschutzgesetz	[]
pressmaschine	[]
servlets/jsp	[]
lst-recht	[src\main\resources\extractedWiki\AA/wiki_00	abkürzungen/gesetze und recht]
bildeditor	[]
tomcat	[]
applikationsautomat	[]
anlagenplanungssoftware	[]
visicad	[]
teamcent	[]
funkenerosionsmaschine	[]
kippvorrichtung	[]
infomix	[]
betonmischgerät	[]
citrix ps	[]
mischer	[]
epl	[]
nas	[src\main\resources\extractedWiki\BT/wiki_98	nase vorn]
freisprechanlage	[]
nav	[]
rohrleitungsplan	[]
xendesktop	[]
ms-professional/ms-office	[]
)html	[]
diagnose-software/bus-system	[src\main\resources\extractedWiki\BV/wiki_98	politisches system indiens, src\main\resources\extractedWiki\CJ/wiki_99	de haan’s bus &amp; coach, src\main\resources\extractedWiki\AM/wiki_02	business software alliance]
forth	[]
r/3.	[]
silverlight	[]
coparts	[]
kaftfahrzeug	[]
heckenschere	[]
glasdrehmaschine	[]
verordnungsgebung	[]
ado.net	[]
langdrehmaschine	[]
xpages	[]
polar-schneidemaschine	[]
brennschneideanlage	[]
sportpferde	[]
betriebssystem	[]
elektrozug	[]
pianos	[]
brandmeldern	[]
erp	[]
simotion	[]
elektrofahrrad	[]
aktionsscript	[]
ecad	[]
bbig	[]
ekrg	[]
esb	[]
arztpraxissoftware	[]
abaqus	[]
betriebsauto	[]
3d-cad-planungstool	[]
wartungsbücher	[]
papier	[]
ecc6	[]
druckluftstrahler	[]
hygieneverordnung	[]
cae-tool	[]
druckbögen	[]
analysegerät	[]
spice	[]
coremedia	[]
kipperfahrzeugen	[]
serverdienst	[]
schweißroboter	[]
produktionsanlage	[]
mathcad	[]
datenmanagementsystem	[]
kipper/sattelkipper	[]
archicad	[]
lan/wan	[]
schemata	[]
kleinnutzfahrzeuge	[]
cad-/cam-anwendung	[]
immobilienrecht	[]
barcodeerfassungsgerät	[]
cnc-maschin	[]
industrienähmaschine	[]
schultafel	[]
lötanlage	[]
cnc-rundschleifmaschin	[]
solidedge	[]
werklok	[]
medistar	[]
etl-programmierung	[]
smarty	[]
html/css/java	[src\main\resources\extractedWiki\BV/wiki_99	css-9]
nfz	[]
arbeitskleidung	[]
sandstrahlen	[]
sandstrahler	[]
hygienegesetz	[]
handmaschine	[]
digitalmultimeter	[]
magento	[]
wettbewerbsrecht	[]
schlauchautomat	[]
tiefladeranhänger	[]
bihler-produktionsmaschine	[]
cnc-fräse	[]
messschieber	[]
energiedatenerfassungssystem	[]
konstruktionszeichnung	[]
röntgengerät	[]
medizin	[src\main\resources\extractedWiki\BT/wiki_95	alexander seitz (mediziner)]
3d-visualisierungsprogrammen	[]
wasserkraftanlage	[]
content-management-systeme	[src\main\resources\extractedWiki\BT/wiki_96	c3 creative code and content]
fem-software	[src\main\resources\extractedWiki\AM/wiki_02	business software alliance]
messschieben	[]
pflegestandard	[]
seithubstapler	[]
xslt	[]
pferd	[src\main\resources\extractedWiki\BV/wiki_98	jäger-regiment zu pferde nr. 9]
adob bridge	[]
zutrittsberechtigungssystem	[]
navision	[]
onespace	[]
rocad	[]
java	[]
schütte traub-maschine	[src\main\resources\extractedWiki\CN/wiki_54	heinrich friedrich schütt]
elektro-haushaltsgerät	[]
e-cad-programm	[src\main\resources\extractedWiki\CJ/wiki_99	liste der öffentlich-rechtlichen hd-programme in europa]
präzisionsfräsmaschine	[]
*word*	[]
reporting-tool	[]
xen/kvm	[]
cad/cam	[]
skriptprogrammierung	[]
drucker	[]
php/mysql/html/javascript	[]
datenbanksystema	[]
nosql	[]
bau-ausschreibungsprogramm	[src\main\resources\extractedWiki\BT/wiki_97	bauen unter dem rollenden rad]
plattenwagen	[]
schiff	[src\main\resources\extractedWiki\CJ/wiki_99	vaderland (schiff, 1900)]
amadeus/toma	[]
mixer	[]
flachbettstanze	[]
sienumerik-steuerung	[]
beosys	[]
flash	[]
transferwerkzeug	[]
portalroboter	[]
catia/proe	[]
elektroameise	[]
pick-up	[src\main\resources\extractedWiki\BT/wiki_97	pick up (film)]
client/server-systemen	[]
mulcher	[]
extbase	[]
nkw	[]
gartenmaschine	[]
sap-produkt	[]
plasmaschneideanlage	[]
ms-officeanwendung	[]
server-betriebssystem	[]
smd-bestückungsautomat	[]
zoll-software	[src\main\resources\extractedWiki\BT/wiki_97	paul maurice zoll, src\main\resources\extractedWiki\AM/wiki_02	business software alliance]
x)html/css	[src\main\resources\extractedWiki\AT/wiki_99	histiozytose x]
schwertransporter	[]
etka	[]
joomola	[]
airless-spritzpistole	[]
elaplan	[]
stahlbaunorm	[]
roboterprogramm	[]
textilmaschine	[]
simulationswerkzeug	[]
anhängerfahrzeug	[]
cargosoft	[]
javascript/ajax	[]
breitbandkommunikationsanlage	[]
metallverarbeitungsmaschine	[]
layoutentwicklungswerkzeug	[]
schlachtanlage	[]
nmr	[]
ftp-programm	[src\main\resources\extractedWiki\CJ/wiki_99	liste der öffentlich-rechtlichen hd-programme in europa]
mikrochip	[]
flurförderfahrzeug	[]
einzelteilzeichnung	[]
hydraulikschaltplan	[]
montage-werkzeug	[]
sqlite	[]
gitarre	[]
dienstauto	[]
hotelreservierungsprogramm	[]
handameis	[]
seeschiff	[]
präzisionsflachschleifmaschine	[]
,hebezeugen	[]
vde-vorschrift	[]
eprogesa	[]
flurförder-zeug	[]
emv-vorschrift	[]
nastran	[]
trockner	[]
küchengerät	[]
navisphere	[]
kurzdreher	[]
werksnorm	[]
kettenbagger	[]
cnc-werkzeugmaschine	[]
cad-geograf	[]
hochregalstapler	[]
catia	[]
liftsystem	[]
db/2	[]
airbrush	[]
sqlserver	[]
microsoft-office-programme	[src\main\resources\extractedWiki\CJ/wiki_99	liste der öffentlich-rechtlichen hd-programme in europa]
kesselwagen	[]
adonis	[]
soap-interfaces	[src\main\resources\extractedWiki\AT/wiki_97	scalable link interface]
sps-steuerung	[]
depo-cam	[]
samba	[]
citrix terminalservice	[]
laserdrucker	[]
konstruktionsprogramm	[]
spannungswandler	[]
lkw-nutzfahrzeug	[]
xhtml	[]
stehameise	[]
bleistift	[]
geomagic	[]
window	[]
fensterautomat	[]
roboteranlage	[]
mm/pp	[]
xml/(	[]
malerzubehör	[]
system-managementsystem	[src\main\resources\extractedWiki\BV/wiki_98	politisches system indiens]
taxen	[]
lastzug	[]
edm-system	[src\main\resources\extractedWiki\BV/wiki_98	politisches system indiens]
fertigungsautomat	[]
logidynd2	[]
waschanlage	[]
aüg	[]
wandsag	[]
seitenstapler	[]
schweißunterlage	[]
fachliteratur	[]
wildfire	[]
immobilienwirtschaftsrecht	[]
powershell	[]
netbean	[]
cnc-drehmaschine	[]
siemens-profinet	[]
fax	[src\main\resources\extractedWiki\CJ/wiki_99	liste der biografien/fax]
dosensenker	[]
citadel	[]
kfz-bus	[src\main\resources\extractedWiki\CJ/wiki_99	de haan’s bus &amp; coach, src\main\resources\extractedWiki\BV/wiki_98	kfz-kennzeichen (philippinen)]
ladenbacköfe	[]
fertiger/bohle	[]
praxissoftware	[]
zyklendrehmaschine	[]
dual-tft-monitore	[]
betonschneidemaschine	[]
ms-office-produkt	[]
ms bi	[]
rettungsfahrzeug	[]
datev-programm	[src\main\resources\extractedWiki\CJ/wiki_99	liste der öffentlich-rechtlichen hd-programme in europa]
warenwirtschaftssystema	[]
zeiterfassung	[]
serienhubwerk	[]
citrix-umgebung	[]
bug-tracker	[]
microchip	[]
kaltkreissag	[]
frontstapler	[]
bundeswehrfahrzeug	[]
hochregal-stapler	[]
säge	[]
mehrspindeldrehautomat	[]
ms office paket	[]
winkelmesser	[]
php/javascript	[]
prüfanweisung	[]
prozessautomatisierungssoftware	[]
frontsitzstapler/seitenstapler	[]
brückenkräne	[]
presswerkzeuge/pressmaschin	[]
ascet	[]
opengl	[]
lieferfahrzeug	[]
asam-mcd-3d	[]
infopath	[]
bildbearbeitungsprogramme	[]
grid	[]
kalkulations-system	[src\main\resources\extractedWiki\BV/wiki_98	politisches system indiens]
industrierobote	[]
hubarbeitsbühn	[]
piezoaktor	[]
entwurfszeichnung	[]
flachschleifmaschine	[]
sap-system	[src\main\resources\extractedWiki\BV/wiki_98	politisches system indiens]
s7/s5	[src\main\resources\extractedWiki\AT/wiki_99	saleen s7]
langdrehautomat	[]
drehbänk	[]
mehrspindelautomat	[]
umsatzsteuerrecht	[]
brückenkran	[]
asp.net	[]
dienstwagen	[]
3d-cad-software	[src\main\resources\extractedWiki\AM/wiki_02	business software alliance]
asp.nen	[]
sysml	[]
layouttool	[]
schraubautomat	[]
ölversorgungsanlage	[]
nx5	[]
nx6	[]
visual studio	[src\main\resources\extractedWiki\BT/wiki_96	pulchri studio]
desktop-pc`	[]
peoplesoft	[]
whg	[]
eagle	[]
schweißzeichnung	[]
ipad	[]
sdlc	[]
gesetz	[src\main\resources\extractedWiki\AA/wiki_00	abkürzungen/gesetze und recht]
asphaltfräse	[]
mobilfunkgerät	[]
lucidshape	[]
spezialausrüstung	[]
speditions-software	[src\main\resources\extractedWiki\AM/wiki_02	business software alliance]
java-ee-programmierung	[]
fachnorm	[]
forstgerät	[]
siemens-steuerung	[]
[zeitarbeitssoftware] "aida"	[]
kettensäge	[]
cnc-dreh-und fräsmaschine	[src\main\resources\extractedWiki\BT/wiki_99	lärm- und vibrations-arbeitsschutzverordnung]
ms-windows/ms-office-produkt	[src\main\resources\extractedWiki\BT/wiki_96	windows developer]
wort/excel	[]
rwa-anlage	[]
mootool	[]
abkantbänken	[]
a+	[]
ct¿s	[]
opencl	[]
serversystem	[]
netzwerk	[]
visio	[]
funktionsplan	[]
perl-skripting	[]
übersichtsplan	[]
insolvenzrecht	[]
auftragssachbearbeitungsprogramm	[]
laborautomat	[]
webservices	[]
linuxkernel	[]
xml/html	[]
windows-server	[src\main\resources\extractedWiki\BT/wiki_96	windows developer]
diensthandy	[]
speditionssoftware	[]
baplie	[]
db2/informix	[]
pflug	[]
profibus	[]
kraftrad	[]
q-norm	[src\main\resources\extractedWiki\AT/wiki_98	europäische norm]
absauganlage	[]
rechtsanwaltsprogramm	[]
hausgerät	[]
c#	[]
c+	[]
spirometer	[]
radialsag	[]
c.	[src\main\resources\extractedWiki\BV/wiki_99	william c. anderson]
c/	[]
software-lizenzrecht	[src\main\resources\extractedWiki\AM/wiki_02	business software alliance]
javaee	[]
schubmaststapler	[]
cad-anlage	[]
abkantmaschine	[]
spritzgusswerkzeug	[]
ax	[]
beatmungsgerät	[]
ausschreibungs-software	[src\main\resources\extractedWiki\AM/wiki_02	business software alliance]
küchenplanungssoftware	[]
anwaltsprogramm	[]
javascript-framework	[]
betriebssoftware	[]
essbase	[]
mssql-server	[]
hyperworks	[]
einrichteblätter	[]
xml-parsing	[]
kücheninventar	[]
mootools	[]
verlegeplan	[]
3d-cad-anwendung	[]
laserkanter	[]
kühlwagen	[]
shop-software	[src\main\resources\extractedWiki\AM/wiki_02	business software alliance]
elektrokleingerät	[]
rdbms	[]
hämerle-biegemaschin	[]
html/xml	[]
systemc	[]
arinc653	[]
[embedded] systems	[]
ct	[]
mori-seiki	[]
cobol	[]
tiefladern	[]
induktionsherd	[]
dampsoft-programm	[src\main\resources\extractedWiki\CJ/wiki_99	liste der öffentlich-rechtlichen hd-programme in europa]
meßsoftware	[]
kochlöffel	[]
facelet	[]
cad-software	[src\main\resources\extractedWiki\AM/wiki_02	business software alliance]
feuerwehrauto	[]
auto cad	[]
gliederzugmaschine	[]
adminstudio	[]
büroverwaltungssoftware	[]
step 7 v5.4	[]
zupfinstrument	[]
dialer	[]
gtkmm/gtk+	[]
jsp,jsf	[]
kantmaschine	[]
allrad-kipper	[]
kartenmaterial	[]
rechtskunde	[]
wpf	[]
hogatex	[]
mysql-datenbank	[]
e-mail-programmen	[src\main\resources\extractedWiki\CJ/wiki_99	liste der öffentlich-rechtlichen hd-programme in europa]
ablaufbeschreibung	[]
php-technologie	[]
simulationssoftware	[]
freischneid	[]
formelsammlung	[]
elektrohandwerksgerät	[]
holzwerkzeug	[]
frequenzumformer	[]
kräne	[]
wohnungseigentumsrecht	[]
windows-officeanwendung	[src\main\resources\extractedWiki\BT/wiki_96	windows developer]
typoscript	[]
smarteam	[]
küchenequipment	[]
spritzgussmachine	[]
cnc-technologie	[]
mac/linux	[src\main\resources\extractedWiki\BV/wiki_97	mac-50]
cakephp	[]
cd-rom	[src\main\resources\extractedWiki\BV/wiki_97	internationale konferenz von rom für die soziale verteidigung gegen anarchisten, src\main\resources\extractedWiki\BV/wiki_98	cd málaga]
cad-planungstool	[]
mechanical2010	[]
internetbrowser	[]
siemenssteuerung	[]
druckweiterverarbeitungsmaschine	[]
obd	[]
datenbank sql	[]
agavi-framework	[]
schleifgerat	[]
pflichtheft	[]
rohrschneider	[]
cnc-biegemaschine	[]
straßenkehrmaschine	[]
kontaktplan	[]
soa-technologie	[]
kippern	[]
windowsserver	[]
pps-system	[src\main\resources\extractedWiki\BV/wiki_98	politisches system indiens]
mobilbagger/raupenbagger	[]
straßenbahn	[src\main\resources\extractedWiki\AT/wiki_99	straßenbahn lwiw]
pdas	[]
netweaver	[]
sap-erp-system	[src\main\resources\extractedWiki\BV/wiki_98	politisches system indiens]
schemaplan	[]
mischanlage	[]
dat-scan	[]
pc-standardprogramm	[]
logistikanlage	[]
step 7	[]
reinigungsgerät	[]
modul-mm	[]
microstation	[]
ca-link	[src\main\resources\extractedWiki\AM/wiki_01	linke opposition in der sowjetunion, src\main\resources\extractedWiki\BT/wiki_96	ca immo]
nähmaschine	[]
komponentenprüfstand	[]
odx	[]
mazatrolsteuerung	[]
ethernet-technologie	[]
abrechnungsrichtlinie	[]
kantbank	[]
reservierungsprogramm	[]
kantenschleifautomat	[]
js	[]
atmel	[]
ws-*	[]
matlab/simulink	[]
heidenhain-steuerung	[]
telekommunikationsanlage	[]
zeitschrift	[src\main\resources\extractedWiki\BT/wiki_98	special-interest-zeitschrift]
gabelstapler	[]
hängerzug	[]
sattelzugmaschine	[]
weblogic	[]
fahrzeug	[]
airlessgerät	[]
draw	[]
presslufthammer	[]
regalbediengerät	[]
fanuk-steuerung	[]
t-sql.	[]
handameise	[]
klimagerät	[]
roboterapplikation	[]
7,cnc	[]
exerpt	[]
fup	[]
werkzeugmaschine	[]
lörürl	[]
microstation + tricad	[]
schwertransport-lkw	[]
hub-ameisen	[src\main\resources\extractedWiki\CJ/wiki_98	michael huber (pfarrer)]
tcp/ip	[]
warenwirtschaftsprogrammen	[]
betonmaschine	[]
edge	[]
wws	[]
ckf-system	[src\main\resources\extractedWiki\BV/wiki_98	politisches system indiens]
windows-xp	[src\main\resources\extractedWiki\BT/wiki_96	windows developer]
papiermaschine	[]
kühlzug	[]
matlab®/simulink®/stateflow	[src\main\resources\extractedWiki\CJ/wiki_99	stateflow]
windowsbetriebssystem	[]
µcontroller	[]
3d-cad-programmen	[src\main\resources\extractedWiki\CJ/wiki_99	liste der öffentlich-rechtlichen hd-programme in europa]
us gaap	[src\main\resources\extractedWiki\AA/wiki_00	us-amerikanischer film]
lenkzeitvo	[]
textilpresse	[]
simatec	[]
flexgerät	[]
orca	[]
planungsrecht	[]
ebydos	[]
assemblydesign	[]
tablett	[]
lastkraftwagen	[]
iso9001	[]
.netframework	[]
wärmeabzugsanlage	[]
radlader	[]
steuergerät	[]
hammer	[src\main\resources\extractedWiki\CJ/wiki_98	landtagswahlkreis hamm i]
q-gate/e-gat	[]
fakturierungssoftware	[]
nt	[]
nx	[]
grafikprogrammen	[]
catia/enovia	[]
einlegewerkzeug	[]
matrix kassensystem	[]
passepartout-computermaschine	[]
ri-schema	[]
papierschneide	[]
cad-3dsystem	[]
telefonanlage	[]
kehrwagen	[]
client/server-systeme	[]
brief	[]
oo	[]
keyboard	[]
os	[]
mockup	[]
babtec	[]
efdis	[]
e-commerce-anwendung	[]
windows-serversystem	[src\main\resources\extractedWiki\BT/wiki_96	windows developer]
cnc-stanzmaschine	[]
pc	[]
kunststoffschweißgerät	[]
e-schaltplan	[]
hotelreservierungssystem	[]
werkzeugschleifen	[]
eplan/ws-cad	[]
haushaltsgroßgerät	[]
zugmaschine	[]
waagesystem	[]
baubit	[]
e-cad-tool	[]
aucoplan	[]
edp-system	[src\main\resources\extractedWiki\BV/wiki_98	politisches system indiens]
firewall-/vpn-/	[]
pc-arbeitsplatz	[]
strömungsmaschine	[]
davit-system	[src\main\resources\extractedWiki\BV/wiki_98	politisches system indiens]
sap wm	[]
c#.net-projekt	[]
hecklader	[]
pl/sql	[]
fördermaschine	[]
s6	[]
qt	[]
urheberrecht	[]
s7	[src\main\resources\extractedWiki\AT/wiki_99	saleen s7]
varimetrix	[]
schließplan	[]
extrusionsmaschinen	[]
squirrel	[]
sattelanhänger	[]
ausschreibungssoftware	[]
ms-office	[]
bodenrecht	[]
grundbuchrecht	[]
cnc-maschinen	[]
fanuc-steuerung	[]
bz-messgerät	[]
xpath	[]
windchill/ eca	[]
steuertableau	[]
sap-r/3	[]
cold fusion	[]
email	[]
holzverarbeitend maschine	[]
dentixsoft	[]
smtp	[]
dokumentenmanagementsystema	[]
esx/vsphere	[]
kehrbese	[]
transportmittel	[]
qualitätsvorgabe	[]
spülmaschine	[]
mitnahmestapler	[]
domino-server	[]
diamant	[]
spezialtransporter	[]
blechbiegemaschine	[]
hochregallager	[]
software-motorprüfstände	[src\main\resources\extractedWiki\AM/wiki_02	business software alliance]
erodiermaschine	[]
monitoringtool	[]
innosoft	[]
ooa	[]
online-datenbank	[]
quipsy	[]
access.	[]
ood	[]
entgratwerkzeuge	[]
diadem	[]
schneid/formwerkzeug	[src\main\resources\extractedWiki\CN/wiki_54	reinhard schneider (autor)]
sheetmetal	[]
oop	[]
sps-programm	[src\main\resources\extractedWiki\CJ/wiki_99	liste der öffentlich-rechtlichen hd-programme in europa]
peripheriegerät	[]
betriebssicherheits-verordnung	[]
navigerät	[]
laserschneidanlage	[]
nutzfahrzeug	[]
simulationstool	[]
pdmu	[]
vb	[]
pdms	[]
mastercam	[]
vm	[]
abbruchroboter	[]
ejb3.	[]
personenwagen	[]
erp-anwendung	[]
windows embedded ce	[src\main\resources\extractedWiki\BT/wiki_96	windows developer, src\main\resources\extractedWiki\BV/wiki_99	ce constància]
dmu-navigator	[]
großflächenrasenmäher	[]
pds-3d	[]
scada	[]
literatur	[src\main\resources\extractedWiki\AM/wiki_00	türkische literatur]
maxdb	[]
sap-r3.	[]
kleintransporter/wohnmobil	[]
smartphon	[]
fachmagazin	[]
winterdienstgerät	[]
sattelzug	[]
sap/esp	[]
schleifpapier	[]
sap businessobject access control	[src\main\resources\extractedWiki\BV/wiki_97	control-l]
powepoint	[]
gießanlage	[]
ms-office-werkzeug	[]
xt	[]
diagtools	[]
kasse	[]
schneideeinrichtung	[]
gcc	[]
auftragsabwicklungssoftware	[]
40t-fahrzeug	[]
smartplant	[]
ms-excel	[]
excenter-presse	[]
activedirectory	[]
materialprüfgerät	[]
osx	[]
zang	[]
hochleistungsbandsag	[]
xen	[]
gießereimodelle	[]
tonner	[]
datenschutzrecht	[]
kreuzfahrschiff	[]
walze	[]
fpga's	[]
rmmap	[]
formenfräsen	[]
autoform	[]
messwerkzeug	[]
microsoft-anwendung	[]
hubgerät	[]
sharepoint	[]
ifrs-richtlinie	[]
glassfish	[]
triebfahrzeug	[]
baumaschin	[]
erp-sytemen	[]
linux/unix	[]
ms-office-programm	[src\main\resources\extractedWiki\CJ/wiki_99	liste der öffentlich-rechtlichen hd-programme in europa]
solidwork	[]
hochgeschwindigkeitsfräsen	[]
microsoft-office-anwendung	[]
pc/plc	[]
abrollerfahrzeugen	[]
stichsag	[]
elektrowerkzeuge	[]
diagnosesystem	[]
erp-software	[src\main\resources\extractedWiki\AM/wiki_02	business software alliance]
serverhardware	[]
typo	[]
wok-pfannen	[]
regalbediengerätesteuerung	[]
infusionspump	[]
microsoft vc	[]
ms/office	[]
elektrostapler	[]
abap/java	[]
norm	[src\main\resources\extractedWiki\AT/wiki_98	europäische norm]
lampe	[]
reachstacker	[]
ava-programm	[src\main\resources\extractedWiki\CJ/wiki_99	liste der öffentlich-rechtlichen hd-programme in europa]
extranet	[]
mathlab	[]
krananlage	[]
zähler	[]
jumbo-zug	[]
müllsammelfahrzeug	[]
sap-pdm	[]
strangpresse	[]
scala	[]
dehnungsmessstreifen	[]
ramicro	[]
ecm-system	[src\main\resources\extractedWiki\BV/wiki_98	politisches system indiens]
klebemaschine	[]
cad-auto	[]
schubmaster	[]
sap apo	[]
lims	[]
prüfsoftware	[]
git	[]
kassen-verbundsysteme	[]
omnibus	[]
3d/cad	[]
scriptsprache	[]
schlepper	[]
cnc-steuerung	[]
gliederzug	[]
mietwagen	[]
bauschaltplan	[]
kleingerät	[]
axapta	[]
herd	[src\main\resources\extractedWiki\BV/wiki_99	herder-preis]
sprinkleranlage	[]
schücal	[]
textverarbeitung	[]
schücad	[]
win7	[]
oberflächenmessgerät	[]
adobe-applikation	[]
firmen-notebook	[]
standard-pc-anwendung	[src\main\resources\extractedWiki\BT/wiki_96	nash standard eight]
subversion	[]
zusammentragmaschine	[]
sägeautomat	[]
vectorwork	[]
herstellungsanlage	[]
server/pc	[]
schußgerät	[]
solaris/aix	[]
absetzer	[]
patientenrufanlage	[]
dosiergerät	[]
xml	[]
any count	[]
fpgas	[]
statikprogramm	[]
rechtsvorschrift	[]
fertigungszeitwirtschaftssystem	[]
laufkran	[]
riemenfallhämmer	[]
arbeitsschutzrecht	[]
konstruktionsrichtlinie	[]
schaltplan	[]
reingigungsmaschine	[]
microsoft office-produkt	[]
ms-excel/-word	[]
works/solid	[]
graphikprogramm	[]
axcms	[]
fräse	[]
rollbahn-system	[src\main\resources\extractedWiki\BV/wiki_98	politisches system indiens]
pps/erp-system	[src\main\resources\extractedWiki\BV/wiki_98	politisches system indiens]
personenkraftwagen	[]
dampferzeuger	[]
simulationsprogramm	[]
sps-maschine	[]
hallenkräne	[]
montagehilfsgerät	[]
akkuschrauber	[]
iseries	[]
mähdrescher	[]
s7-sps-steuerung	[src\main\resources\extractedWiki\AT/wiki_99	saleen s7]
sd,mm	[]
werkzeichnung	[]
bedienpult	[]
xquery	[]
verdichtungsgerat	[]
sattelzugmaschiene	[]
outook	[]
bohrgerät	[]
gnu	[]
pfandbg	[]
highcad	[]
neumaschine	[]
lagerwirtschaftsprogramm	[]
höhenmessgerät	[]
arbeitsplatzrechner	[]
farblehre/	[]
messschraube	[]
indralogic	[]
ecxel	[]
tabellenkalkulationsprogramm	[]
ris/pacs	[]
bohrer	[]
biegemaschiene	[]
kuka-roboter	[]
flurförderzeug	[]
ec-zahlungsgerät	[]
messprogramm	[]
hand bzw. airmixpumpe	[src\main\resources\extractedWiki\BV/wiki_99	white hand gang]
wise	[src\main\resources\extractedWiki\AM/wiki_02	john wise (pfarrer)]
goz	[]
cnc-erodiermaschine	[]
pc(	[]
it-recht	[src\main\resources\extractedWiki\AA/wiki_00	abkürzungen/gesetze und recht]
stadtbussen	[]
hygienestandard	[]
webdynpro	[]
is-u	[]
galvanikanlage	[]
elektrokran	[]
cad-datenbankensystemen	[]
landmaschinen-/	[]
zuschneidsag	[]
vob.	[]
pkw`s	[]
xaml/wpf	[]
abap-oo	[]
windows/linux	[src\main\resources\extractedWiki\BT/wiki_96	windows developer]
rührbehälter	[]
adwords	[]
xsd	[]
pc`	[]
icon-l	[]
xsl	[]
pear	[]
crm-kv	[]
sondermessmittel	[]
vestracad	[]
sonicwall	[]
easymed/easywin	[]
kassensysteme	[]
handgerät	[]
re-fx	[]
pcs	[]
ms server	[]
liegenschaftsrecht	[]
fi/co	[src\main\resources\extractedWiki\BT/wiki_96	wi-fi protected setup, src\main\resources\extractedWiki\CJ/wiki_98	mpc münchmeyer petersen &amp; co.]
hubbühne	[]
kipplaster	[]
em-workplace	[]
betriebssystemsoftware	[]
magazine	[]
catia.	[]
windows-ce	[src\main\resources\extractedWiki\BT/wiki_96	windows developer, src\main\resources\extractedWiki\BV/wiki_99	ce constància]
goä	[]
12-t-lkw	[src\main\resources\extractedWiki\CJ/wiki_99	autovía a-12]
bedieneroberfläche	[]
wechselbruck	[]
snmp	[]
zugfahrzeug	[]
holzumschlaggerät	[]
mega-cad	[]
fotoapparat	[]
cnc-abkantbank	[]
deskpack	[]
s7-300	[src\main\resources\extractedWiki\AT/wiki_99	saleen s7]
ausklingroboter	[]
php/asp	[]
kehlmaschine	[]
ms-office-system	[src\main\resources\extractedWiki\BV/wiki_98	politisches system indiens]
e-mail	[]
seitenschubmaststapler	[]
mikrocomputersystem	[]
windows-standardsoftware	[src\main\resources\extractedWiki\BT/wiki_96	windows developer]
speditionsprogramm	[]
phyton	[]
xml/xsd	[]
hgb/bilmog	[]
handmessmittel	[]
xml/xsl	[]
pc¿	[]
sonderfahrzeuge	[]
innovator	[]
c/modula-2/pascal	[]
wechselbrückenzug	[]
sap/fico	[]
presswagen	[]
schreibmaschine	[]
zweiräd	[]
pspice	[]
hogatex-programm	[src\main\resources\extractedWiki\CJ/wiki_99	liste der öffentlich-rechtlichen hd-programme in europa]
unix/linux	[]
cnc-bearbeitungsmaschine	[]
handscannergerät	[]
tiefziehmaschine	[]
baukräne	[]
cad/cae-system	[src\main\resources\extractedWiki\BV/wiki_98	politisches system indiens]
mehrspindel	[]
siemens-d840-drehmaschine	[]
lineal	[]
kommissionierfahrzeug	[]
hakenabrollkipper	[]
aufstellungsplan	[]
kommunalrecht	[]
schweißgerät	[]
biegewerkzeuge	[]
storage-system	[src\main\resources\extractedWiki\BV/wiki_98	politisches system indiens]
java-framework	[]
mautgerät	[]
coreldraw	[]
spektrumanalysator¿	[]
verleimungsmaschine	[]
flash/action script	[]
boschsteuerung	[]
feuerwehrfahrzeug	[]
php	[]
arm3	[]
textverarbeitungssystem	[]
firebird	[]
gwt	[]
wechselkoffer	[]
netzwerkanalysator	[]
ketl-tauchlackieranlage	[]
waagen	[]
handlings-gerät	[]
sps-standardsoftware	[]
cae-comos	[]
junit-test	[src\main\resources\extractedWiki\BT/wiki_99	brückner-test]
perlmühlen	[]
voip	[]
mobilgerät	[]
innenlader	[]
,ct	[]
programmieroberfläche	[]
piaggio-roller	[]
enterasys/cisco	[]
gxt	[]
bleschblasinstrument	[]
landmaschine	[]
feuerlöschgerät	[]
luftentfeuchtungsanlage	[]
visual basic scrip	[]
lagersysteme	[]
openedg	[]
office-applikation	[]
stapler/ameise	[]
personalsoftware-programmen	[src\main\resources\extractedWiki\CJ/wiki_99	liste der öffentlich-rechtlichen hd-programme in europa]
jugendrecht	[]
nagler	[]
straßenverkehrsrecht	[]
basic	[]
blutdruckmessgerät	[]
bocad	[]
open-source-bibliotheken	[src\main\resources\extractedWiki\CN/wiki_55	bibliothek des hauses usher, src\main\resources\extractedWiki\BV/wiki_99	swedish open]
biegemaschinen	[]
industrierobot	[]
wm/mm	[]
spritze	[]
ms-office-anwendung	[]
jquery	[]
steuerungselement	[]
xml-schnittstelle	[]
navigationssystem	[]
php 5	[src\main\resources\extractedWiki\BV/wiki_97	dongfeng 5]
php/mysql	[]
coscom	[]
sap-sd	[]
läppmaschine	[]
cad/inventor	[]
ruby-on-rails	[src\main\resources\extractedWiki\BV/wiki_99	committee of legal advisers on public international law, src\main\resources\extractedWiki\CJ/wiki_98	ruby o. fee]
e³cable	[]
barracuda	[]
lamp	[]
arzneimittelgesetz	[]
verpackungssondermaschine	[]
sicherheitsanlage	[]
plm	[]
messgerat	[]
labview	[]
wertvertragsrecht	[]
3d-konstruktionssystemen	[]
drahtschneide	[]
cad-programm	[src\main\resources\extractedWiki\CJ/wiki_99	liste der öffentlich-rechtlichen hd-programme in europa]
bahn/bus	[src\main\resources\extractedWiki\AT/wiki_99	leuk-leukerbad-bahn, src\main\resources\extractedWiki\CJ/wiki_99	de haan’s bus &amp; coach]
gefstoffv	[]
word/excel/internet	[]
karusseldrehmaschine	[]
pm-tool	[]
präzisionsmessmittel	[]
ajax	[]
acces-db	[]
kraftfahrzeug	[]
schnittmaschine	[]
xml/xslt	[]
xt-commerce	[]
kipperfahrzeug	[]
linearbeschleuniger	[]
virtualisierungssystem	[]
javascript	[]
arbeits-/sozialrecht	[src\main\resources\extractedWiki\AA/wiki_01	arbeit (sozialwissenschaften)]
groovy	[]
sv-recht	[src\main\resources\extractedWiki\AT/wiki_98	sv germania bietigheim (bietigheim, baden), src\main\resources\extractedWiki\AA/wiki_00	abkürzungen/gesetze und recht]
axapter	[]
flugzeugschlepper	[]
bündelgerät	[]
kranbahn	[]
abrollkipper	[]
mobilholzhacker	[]
as400	[]
html/css	[src\main\resources\extractedWiki\BV/wiki_99	css-9]
hibernate	[]
doppelgabelstapler	[]
neufahrzeug	[]
planzug	[]
cad-solidwork	[]
(7b) pkw, taxi, motorrad, bus	[src\main\resources\extractedWiki\CJ/wiki_99	de haan’s bus &amp; coach, src\main\resources\extractedWiki\CJ/wiki_98	reise motorrad]
getränkemaschine	[]
hr/pi/fi/crm	[src\main\resources\extractedWiki\BT/wiki_96	wi-fi protected setup]
okuma-steuerung	[]
doppelstock-wendezug	[]
geograf	[]
systemschaltplan	[]
vb-scripting	[]
statistiksoftware	[]
yaw	[]
stanznibbel-maschine	[]
pps	[]
ppt	[]
verpackungsmaschin	[]
vibroplatte	[]
kardiogerät	[]
pro-engineer	[]
cae-anwendung	[]
wärmepumpanlage	[]
datenverwaltungssystem	[]
kehrmaschine	[]
bi/bw	[]
card/1	[]
peps	[]
straßenbaumaschine	[]
mietrecht	[]
neuwagen	[]
hypermesh	[]
kaltfräse	[]
fertigungsplan	[]
spritzgießwerkzeug	[]
parkhausabfertigungsanlage	[]
schichtdesignsoftware	[]
sp-steueranlage	[]
bügelmessschraube	[]
internet-browser	[src\main\resources\extractedWiki\AT/wiki_98	rich internet application]
wechselbrücke	[]
warenwirtschaftprogrammen	[]
office-produkt	[]
fleischverarbeitungsanlage	[]
htlm/css	[src\main\resources\extractedWiki\BV/wiki_99	css-9]
schneid-/formwerkzeug	[src\main\resources\extractedWiki\CN/wiki_54	reinhard schneider (autor)]
kartuschenpresse	[]
windkraft-anlage	[]
handscann	[]
.net	[]
steuerungssoftware	[]
solid edge	[]
lcable	[]
lastzug/gliederzug	[]
psa	[]
arzneimittelsicherheit	[]
vs2008	[]
psi	[]
jdbc	[]
sektvo	[]
airlessanlage	[]
großgerät	[]
multi-cad	[]
xml.	[]
folgeverbundwerkzeug	[]
javascript/ayax	[]
reinigungsmaschine	[]
biegeautomat	[]
richtfunkanlage	[]
berufsbekleidung	[]
sensoren	[]
perl	[]
archivserver	[]
junit	[]
falzmaschine	[]
produktionsmaschine	[]
cnc/nc	[]
assembler	[]
solofahrzeug	[]
windows	[src\main\resources\extractedWiki\BT/wiki_96	windows developer]
wärme-pumpen	[]
raupe	[]
horizontalbohr	[]
xml/dtd/xslt/stylesheet	[]
kunststoffspritzgießmaschine	[]
bohrmaschine	[]
kartonverschließer	[]
mehrachs-maschine	[]
mysql.	[]
projektplan	[]
trac	[]
kanban	[]
projektor	[]
entwicklungswerkzeug	[]
plattenbohrwerk	[]
tieflochbohr	[]
autocad-2d	[]
centro-faktura	[]
stanz-laser-maschine	[]
ruby-on-rail	[src\main\resources\extractedWiki\BV/wiki_99	committee of legal advisers on public international law, src\main\resources\extractedWiki\CJ/wiki_98	ruby o. fee]
scherenbühne	[]
arbeitnehmerüberlassungsgesetz	[]
planierraupe	[]
fassadenbefahranlage	[]
stanze	[]
jacorb	[]
m-bus	[src\main\resources\extractedWiki\CJ/wiki_99	de haan’s bus &amp; coach]
kühlfahrzeug	[]
simovert	[]
regelgerät	[]
strafrecht	[]
reisebürosystem	[]
hgb	[]
make-up	[src\main\resources\extractedWiki\BT/wiki_97	pick up (film)]
bugzilla	[]
rundtischautomat	[]
javaserverfaces	[]
fördergerät	[]
fibersim	[]
labwindows/cvi	[]
hochspannungsgerät	[]
schredder	[]
steuereinrichtung	[]
javascript/jquery	[]
hoai	[]
telelader	[]
duria	[]
stichsäge	[]
q-da	[src\main\resources\extractedWiki\CN/wiki_54	franco da rocha]
access-datenbank	[]
vob/bgb	[]
rezept	[]
regalfahrzuegen	[]
bcdboot	[]
fräser	[]
chat	[]
schneidanlage	[]
microsoft server produkt	[]
drehautomat	[]
abwieger	[]
lsa+	[]
rhino	[]
obendrehkräne	[]
netzwerktechnologie	[]
handlinggerat	[]
putzmaschine	[]
irfs	[]
lkw-ladekran	[]
auerswald/agfeo	[]
kernspingerät	[]
transferpresse	[]
windows-server-betriebssystem	[src\main\resources\extractedWiki\BT/wiki_96	windows developer]
cadwork	[]
windows7	[]
,word	[]
kidicap	[]
ameise	[]
back<f6>fen	[]
zentrifug	[]
cad-tool	[]
pze	[]
z/os	[]
pistolen	[]
edgecam	[]
qm-system	[src\main\resources\extractedWiki\BV/wiki_98	politisches system indiens]
messuhr	[]
hubmast	[]
as 400	[src\main\resources\extractedWiki\BT/wiki_96	nash 400]
eclipse	[]
hebezeug	[]
anwaltssoftware	[]
tx-traub	[]
net-framework	[]
redaktionssystem	[]
prüfgerät	[]
thermoauflieger	[]
kleinger<e4>t	[]
cad-zeichenprogramme	[]
dhtml	[]
soap	[]
carat-programm	[src\main\resources\extractedWiki\CJ/wiki_99	liste der öffentlich-rechtlichen hd-programme in europa]
koordinatenmessmaschine	[]
mähdresch	[]
hebebühnenfahrzeug	[]
warenwirtschaftssystemen	[]
wickelmaschine	[]
sinamic	[]
lamp-architektur	[src\main\resources\extractedWiki\CJ/wiki_98	mozarabische architektur]
bewehrungsplan	[]
planen-/sattelzug	[]
klavier	[]
radbagger	[]
sgb v	[src\main\resources\extractedWiki\BT/wiki_99	john v. tunney]
4-zinken-stapler	[]
zulassungsdatenbank	[]
matlab/simulink-anwendung	[]
gepäckband	[]
animationssoftware	[]
lackieranlage	[]
mikrosystemtechnik	[]
html/css/javascript	[src\main\resources\extractedWiki\BV/wiki_99	css-9]
magentocommerce	[]
pc-office-programm	[src\main\resources\extractedWiki\CJ/wiki_99	liste der öffentlich-rechtlichen hd-programme in europa]
matlab®	[]
kleinbus	[]
betreuungsrecht	[]
abroller	[]
schiffssteuerungssystem	[]
siebmaschine	[]
behördenvorschrift	[]
usgaap	[]
xsl-fo	[]
stufenbohrer	[]
planungstool	[]
e-handschweiß	[]
radialbohr	[]
computertomographie	[]
lkw's	[]
saugwagen	[]
werkzeug	[]
stromlaufpäne	[]
spring/hibernate	[]
prägwerkzeug	[]
verordnung	[]
bw-wartungdokumentationssystem	[]
steinsäge	[]
wasseraufbereitungsanlage	[]
webas	[]
abap	[]
kamera	[src\main\resources\extractedWiki\CJ/wiki_98	goldene kamera 1996]
isb cad	[]
abas	[]
spritzgusszelle	[]
betriebsanleitung	[]
stehschnellläufer	[]
pneumatik-maschine	[]
administrationswerkzeug	[]
patran/nastran	[]
finanzsoftware	[]
erpsystem	[]
cnc-maschine	[]
projektierungswerkzeug	[]
wsdl	[]
mysqldatenbank	[]
managed-c++	[]
comet	[]
tribon	[]
langgabel-stapler	[]
step7	[]
arbeitsrecht/arbeitssicherheit	[src\main\resources\extractedWiki\AA/wiki_03	arbeitsrecht (deutschland)]
logo-cad	[]
step5	[]
ms-query	[]
verkehrsrecht	[]
computer-tomograph	[src\main\resources\extractedWiki\AA/wiki_00	liste von abkürzungen (computer)]
web-design	[src\main\resources\extractedWiki\CN/wiki_53	franz-weber-hof]
heißkanalgerät	[]
rsync	[]
cnc-zerspanungs maschine	[]
sps-programmiersprachen	[src\main\resources\extractedWiki\AM/wiki_02	limbo (programmiersprache)]
fibu	[]
mh-software	[src\main\resources\extractedWiki\AM/wiki_02	business software alliance]
rauchmeld	[]
r<f6>ntgenger<e4>t	[]
entgrater	[]
projektplanungssoftware	[]
betonschleifgerät	[]
kranwagen	[]
infor	[]
ethernet-system	[src\main\resources\extractedWiki\BV/wiki_98	politisches system indiens]
2d/3d-cad-systemen	[]
safan	[]
debugger	[]
astaro	[]
pappe	[]
heißmangel	[]
repromanager	[]
cnc-bohrwerk	[]
laserstrahlanlage	[]
arbeitsbühne	[]
erp-systemen	[]
nutzfahrzeuge	[]
winword	[]
schmalgang-stapler	[]
schlagschrauber	[]
oracle-datenbanken	[]
autocad-pc	[]
messsoftware	[]
wassertemperiergerät	[]
xcode	[]
microsoft-betriebssystem	[]
frontlader	[]
gaswarngerät	[]
emv-norm	[src\main\resources\extractedWiki\AT/wiki_98	europäische norm]
strangschema	[]
irqa	[]
fem-simulationssystem	[]
bürokommunikations-software	[src\main\resources\extractedWiki\AM/wiki_02	business software alliance]
laufkarte	[]
schablonendrucker	[]
maishäcksler	[]
dominoserver	[]
messsystem	[]
in-design	[src\main\resources\extractedWiki\AM/wiki_01	linke opposition in der sowjetunion]
cad-anwendung	[]
statistik-software	[src\main\resources\extractedWiki\AM/wiki_02	business software alliance]
pelletsanlage	[]
bäckereimaschine	[]
hicad/helio	[]
kg-gerät	[]
grundstücksrecht	[]
adobe-ilustrator	[]
lasermaschine	[]
rufanlage	[]
mc-office-programm	[src\main\resources\extractedWiki\CJ/wiki_99	liste der öffentlich-rechtlichen hd-programme in europa, src\main\resources\extractedWiki\BT/wiki_99	road runners mc]
monitor	[]
mikroskope	[]
etl-tool	[]
pc¿s	[]
ms-standardsoftware	[]
fräsmaschine	[]
isa server	[]
hochregal	[]
linksherzkatheter-messplatz	[]
bildschirm	[]
sd/crm	[]
cnc-fanuc	[]
vxwork	[]
baugerät	[]
schneitanlage	[]
kps-programm	[src\main\resources\extractedWiki\CJ/wiki_99	liste der öffentlich-rechtlichen hd-programme in europa]
dreamweaver	[]
bürste	[]
simulation	[]
ladekipper	[]
spezialcontainer	[]
backupexec	[]
handy/fax	[src\main\resources\extractedWiki\CJ/wiki_99	liste der biografien/fax]
ehealth	[]
heizölanlage	[]
umformungswerkzeug	[]
extrusionswerkzeug	[]
tablet	[]
sinumeric-steuerung	[]
caq-software	[src\main\resources\extractedWiki\AM/wiki_02	business software alliance]
laserscanner	[]
roboter	[]
kassenbuch	[]
werksvertragsrecht	[]
multislice-ct	[]
python	[]
elektrotacker	[]
officeanwendung	[]
auflieger	[]
steuerberater-branchen-softwar	[src\main\resources\extractedWiki\AM/wiki_02	business software alliance]
einkaufsinformationssystem	[]
förderanlage	[]
coilmaschine	[]
hibernate/jpa	[]
standbohrmaschine	[]
staplerzug	[]
programmiersprach	[src\main\resources\extractedWiki\AM/wiki_02	limbo (programmiersprache)]
vda6.1-normen/ts16949	[]
umess	[]
schaltpult	[]
hydraulikbagger	[]
telefaxgerät	[]
asp.	[]
desktop-publishing-system	[src\main\resources\extractedWiki\AT/wiki_97	quark publishing system, src\main\resources\extractedWiki\BV/wiki_98	politisches system indiens]
ile-rpg	[]
3d via	[]
asme	[]
artpro	[]
typogento	[]
autokrane	[]
biegemaschine	[]
is-u modul	[]
rechtsanwalts-software	[src\main\resources\extractedWiki\AM/wiki_02	business software alliance]
ziehwerkzeug	[]
winkelschleifer	[]
.net/wpf	[]
ausformmaschine	[]
statistikprogramm	[]
linux/apache	[]
asme-code	[src\main\resources\extractedWiki\BT/wiki_96	c3 creative code and content]
q-gate/e-gate	[]
aspx	[]
entstauber	[]
kipper	[]
scangerät	[]
sgbv	[]
industriekran	[]
hubarbeitsbühnen	[]
java/extgwt/senacha	[]
cnc-blechbearbeitungsmaschine	[]
afa-programm	[src\main\resources\extractedWiki\CJ/wiki_99	liste der öffentlich-rechtlichen hd-programme in europa]
cad-prog	[]
trecker	[]
wscad	[]
sap-modul	[]
crm-system	[src\main\resources\extractedWiki\BV/wiki_98	politisches system indiens]
content-management-system	[src\main\resources\extractedWiki\BV/wiki_98	politisches system indiens, src\main\resources\extractedWiki\BT/wiki_96	c3 creative code and content]
ava-software	[src\main\resources\extractedWiki\AM/wiki_02	business software alliance]
fertigungsmaschine	[]
panel-software	[src\main\resources\extractedWiki\AM/wiki_02	business software alliance]
start/amadeus	[]
seilsäge	[]
fehler-management-tool	[]
linux/windows	[src\main\resources\extractedWiki\BT/wiki_96	windows developer]
php/symfony/orm	[]
cad-produkt	[]
vpns	[]
windpro	[]
crm-software	[src\main\resources\extractedWiki\AM/wiki_02	business software alliance]
düngemaschine	[]
k+h software	[src\main\resources\extractedWiki\AM/wiki_02	business software alliance]
praxissystem	[]
datevpro	[]
wurzelstockfräse	[]
lan/wlan?	[]
feinmessmittel	[]
3-d-cad-konstruktion	[]
web-editor	[src\main\resources\extractedWiki\CN/wiki_53	franz-weber-hof]
handlingssystem	[]
zollmaßband	[]
ms-sql-server	[]
rhapsody	[]
codesys	[]
riesenpfanne	[]
traub	[]
montageanlage	[]
radlader**	[]
stadtbahnfahrzeug	[]
uv-goä	[]
handschleifmaschine	[]
reinraumanlage	[]
ruby	[src\main\resources\extractedWiki\CJ/wiki_98	ruby o. fee]
kühltruhe	[]
aufbereitungsmaschine	[]
cad-vorlage	[]
safexpert	[]
ms-office-modul	[]
wood-wop	[]
portalsoftware	[]
cross-development-tool	[src\main\resources\extractedWiki\CN/wiki_55	southern-cross-expedition/mannschaftsliste]
qnx	[]
vpn?	[]
firmenmobiltelefon	[]
vektorwork	[]
planschneider	[]
sap/r§	[]
bürokopierer	[]
spektrumanalysator	[]
40-to-lastzug	[]
aufbereitungsanlage	[]
3d-cad	[]
megatrailer	[]
unit-test-tool-chain	[src\main\resources\extractedWiki\BT/wiki_99	brückner-test]
case-maschinen	[]
qualitätssicherungsprogramme	[]
rasentraktor	[]
sackkarr	[]
ms-office-module	[]
taxi	[]
schleifroboter	[]
kalkulationssoftware	[]
cad-solid-work	[]
lagerverwaltungssystem	[]
luftfahrzeug	[]
factfinder	[]
industrie-pc	[src\main\resources\extractedWiki\CN/wiki_53	industrie- und handelskammer hanau-gelnhausen-schlüchtern]
word/excel/powerpoint	[]
lastwagen	[]
standard-softwareprogramm	[src\main\resources\extractedWiki\BT/wiki_96	nash standard eight]
khbv	[]
computerkasse	[]
glieder-/tandemzug	[]
excle	[]
klemmplan	[]
waschmaschine	[]
baggerlader	[]
tricad	[]
µp	[]
erdbewegungsmaschine	[]
kreditrecht	[]
seiger	[]
msoffice	[]
nagelschussgerät	[]
c/c++/c#	[]
arburg-spritzgussmaschine	[]
luftförderanlage	[]
nivelliergerät	[]
jsp-technologie	[]
seitenhub	[]
mittelspannungsanlage	[]
schneidmaschine	[]
microsoft® office	[]
ms-offic	[]
maßband	[]
comos	[]
microsoft-server-produkt	[]
installshield	[]
sap/r3	[]
becher-pistolen	[]
digitalpiano	[]
racos	[]
word/excel	[]
vhdl	[]
ms-exchange	[]
linux-os	[]
spezialfahrzeug	[]
fahr-zeug	[]
großküchen	[]
montageunterlage	[]
gießereimaschine	[]
flachfelddetektor	[]
leistungsrecht	[]
multimedia-pc	[]
rüttelplatte	[]
druckprüfmaschine	[]
skriptsprache	[]
ide	[]
krankenhausgesetzgebung	[]
messwerkzeuge	[]
druckluftaufbereitungsanlage	[]
simulat	[]
planenzug-fahrzeug	[]
flugzeug	[]
hotelreservierungssoftware	[]
bauvertragswesen	[]
clearcase	[]
windows-office-programme	[src\main\resources\extractedWiki\BT/wiki_96	windows developer, src\main\resources\extractedWiki\CJ/wiki_99	liste der öffentlich-rechtlichen hd-programme in europa]
ruplan	[]
nc-maschine	[]
haedset	[]
ms-office-software	[src\main\resources\extractedWiki\AM/wiki_02	business software alliance]
cadim	[]
mcs-isynet	[]
ausschreibungsprogramm	[]
autocad	[]
cadis	[]
industrie-nähmaschin	[src\main\resources\extractedWiki\CN/wiki_53	industrie- und handelskammer hanau-gelnhausen-schlüchtern]
otrs	[]
elektroherde	[]
mozilla-solid	[]
groupware	[]
debian	[]
linux	[]
xp/7	[]
hybridbus	[]
wolfwin	[]
firmenwagen	[]
reisezugwagen	[]
schaber	[]
datenvisualisierungssoftware	[]
ms-produkt	[]
cybelec/trumpf-steuerung	[]
arm cortex m3	[]
trailerzug	[]
proengineer	[]
wasserwagen	[]
xml-editor	[]
cnc-abkantpresse	[]
olap	[]
adobe dreamweaver	[]
plm-system	[src\main\resources\extractedWiki\BV/wiki_98	politisches system indiens]
desktop-betriebssystem	[]
tieflader	[]
auto-cad	[]
hubbühn	[]
standardmessgerät	[]
röntgen	[]
3-d-messmaschine	[]
word/excel/access	[]
terminalserver	[]
seitenhubstapler	[]
kaffeeautomat	[]
stapler	[]
patentrecht	[]
rundtischmaschine	[]
industrietastatur	[]
raupen	[]
ihe	[]
sap/mm	[]
profinet	[]
oszilloskope	[]
autoit	[]
qs9001	[]
scada-system	[src\main\resources\extractedWiki\BV/wiki_98	politisches system indiens]
finanzbuchhaltungssytem	[]
cad/cam-system	[src\main\resources\extractedWiki\BV/wiki_98	politisches system indiens]
granid	[]
pascal	[]
simulationsterminals	[]
qualitätsmanagementsystem	[]
ansys workbench	[]
geschirrspüler	[]
iis	[]
geocad	[]
powermta	[]
jumbo-gliederzüge	[]
datenblatt	[]
stanzmaschine	[]
asbwin	[]
kehlautomat	[]
hsqldb	[]
lohnsteuerrrecht	[]
rdms	[]
ms-outlook	[]
bash-scripting	[]
excel	[]
bgv-a3	[]
exenterpresse	[]
stanzmaschinen	[]
netzwerkbetriebssystem	[]
hydraulikschmemata	[]
cnc-programm	[src\main\resources\extractedWiki\CJ/wiki_99	liste der öffentlich-rechtlichen hd-programme in europa]
microsoft betriebssystema	[]
zeitmessgerät	[]
symfony	[]
opentext	[]
arbeitsrecht	[src\main\resources\extractedWiki\AA/wiki_03	arbeitsrecht (deutschland)]
achterzug	[]
q-managementsystem	[]
xp/vista/7	[]
bediensoftware	[]
j2ee	[]
php4/php5	[]
cnc-dreh	[]
programmiersoftware	[]
lastenaufzug	[]
server-anlage	[]
gnu/unix tools	[]
ubuntu	[]
12-tonnern	[src\main\resources\extractedWiki\CJ/wiki_99	autovía a-12]
blechtafelscher	[]
workstation	[]
hänel-liftsystem	[]
groupware-server	[]
sap r/3	[]
mäklerrammgerät	[]
excell	[]
windows power shell	[src\main\resources\extractedWiki\BT/wiki_96	windows developer]
squid	[]
abrechnungssoftware	[]
arcgis	[]
pc-standardsoftware	[]
interred	[]
stickmaschine	[]
client-server	[]
amesim	[]
kernspintomograph	[]
solid works	[]
schwertransportwesen	[]
siebe	[]
protel	[]
sap/fi	[src\main\resources\extractedWiki\BT/wiki_96	wi-fi protected setup]
hobelmaschine	[]
alias/icem surf	[]
hyperv	[]
acad	[]
microsoft<u+00ae> project server	[]
cnc-fräsmaschin	[]
zollstock	[]
e-mails	[]
nutzkraftwagen	[]
drahtbürste	[]
case tool	[]
vollhartmetallbohrer	[]
standardsoftware	[]
ios	[]
5-achsfräsmaschine	[]
abfüllanlage	[]
ladeneinrichtungsplan	[]
walzen	[]
planenzug	[]
e-stapler	[]
hardware-plan	[]
handwerkzeug	[]
aktg	[]
kunststoff-spritzgießwerkzeug	[]
microcontroller	[]
selbstlader	[]
akte	[]
c/side	[]
office-palette	[]
motorgerät	[]
umformenwerkzeug	[]
softwarequalitätsstandard	[]
motorrädern	[src\main\resources\extractedWiki\CJ/wiki_98	reise motorrad]
normenwerk	[]
kassen-computer	[src\main\resources\extractedWiki\AA/wiki_00	liste von abkürzungen (computer)]
konfektionierungsanlage	[]
inventor-3d	[]
typo3.	[]
c#/.net	[]
gefahrgutverordnung	[]
server/client	[]
websprache	[]
nat/pat	[src\main\resources\extractedWiki\BV/wiki_98	pat moylan]
chipkartenleser	[]
smartphones	[]
fll-richtlinie	[]
arriba	[]
schubmaststapler/seitenstapler	[]
plc/ethernet	[]
excel/word	[]
drahtbürst	[]
gnu-/unix-tool	[]
richfaces	[]
gefahrguttransporter	[]
industrieröstmaschine	[]
lkw'	[]
elcad	[]
albis	[]
ce-klasse-fahrzeug	[src\main\resources\extractedWiki\BV/wiki_99	ce constància]
s4wt	[]
schaltanlage	[]
maßtabelle	[]
zug	[]
mysap	[]
j2me	[]
mobiltelefon	[]
verdrahtungstabelle	[]
endoskop	[]
ada	[]
adf	[]
datev-system	[src\main\resources\extractedWiki\BV/wiki_98	politisches system indiens]
lkws	[]
siemens 840 d	[src\main\resources\extractedWiki\CN/wiki_55	d. i. go pop]
clientbetriebssystemen	[]
zvg	[]
erp/crm	[]
druckform	[]
minitab	[]
schrauber	[]
hebeb<fc>hne	[]
ansys...	[]
pressenwerkzeug	[]
shell	[]
exel	[]
matlab/simulink/stateflow	[src\main\resources\extractedWiki\CJ/wiki_99	stateflow]
schweissroboter	[]
query designer	[]
exchange	[]
lkw`	[]
datenfunk	[]
ms-projekt	[]
lageranlage	[]
cad-micro-station	[]
dokumentenmanagement-system	[src\main\resources\extractedWiki\BV/wiki_98	politisches system indiens]
handys	[]
cnc-fräsmaschine	[]
stanz-nibbelmaschine	[]
engineeringtool	[]
pcs-7	[]
rundheit-/rauheitsmessgeräte	[]
lkw¿	[]
office-system	[src\main\resources\extractedWiki\BV/wiki_98	politisches system indiens]
visual basic	[]
javascript-cod	[src\main\resources\extractedWiki\BT/wiki_96	c3 creative code and content]
zeichnungsnorm	[]
laptops	[]
kernspin	[]
trockenhaube	[]
flurf<f6>derfahrzeug	[]
kutsche	[src\main\resources\extractedWiki\BT/wiki_99	gig (kutsche)]
markenrecht	[]
unigraphic	[]
laborcomputer	[]
plotter	[]
agb	[]
office-paket	[]
autodesk	[]
glasinnenlader	[]
c++	[]
ct-gerät	[]
glasschleifmaschine	[]
rib	[]
fräs-maschine	[]
sortieranlage	[]
modellierungssprach	[]
abrechnungssystem	[]
bauanweisung	[]
ad-regelwerk	[]
kostenrecht	[]
scannerkasse	[]
mill-plus-steuerung	[src\main\resources\extractedWiki\BV/wiki_98	alley mills]
elektro-cad	[]
ris	[]
digital-multimeter	[]
arztsoftware	[]
netzwerk-management-tools	[]
löschanlage	[]
yourkit	[]
fi co	[src\main\resources\extractedWiki\BT/wiki_96	wi-fi protected setup, src\main\resources\extractedWiki\CJ/wiki_98	mpc münchmeyer petersen &amp; co.]
planenfahrzeug	[]
elektrowerkzeug	[]
lastenheft	[]
teleskope	[]
c-#	[]
bestückautomat/	[]
ms-window	[]
kühlgerät	[]
ms office	[]
brennschneidanlage	[]
vergaberecht	[]
8d-report	[]
excel/word/powerpoint	[]
aix	[]
windkraftanlage	[]
papiermaschin	[]
haushaltgerät	[]
schwenkbiegemaschine	[]
prüftsoftware	[]
docubridge	[]
sägewerksmaschine	[]
umformgroßwerkzeug	[]
ausschreibungsprogrammen	[]
websphere®	[]
handbücher	[]
konstruktionsunterlage	[]
nähautomat	[]
layout-programme	[src\main\resources\extractedWiki\CJ/wiki_99	liste der öffentlich-rechtlichen hd-programme in europa, src\main\resources\extractedWiki\BV/wiki_98	layout-engine]
email-programmen	[src\main\resources\extractedWiki\CJ/wiki_99	liste der öffentlich-rechtlichen hd-programme in europa]
kunststoffbearbeitungsmaschine	[]
motorrad	[src\main\resources\extractedWiki\CJ/wiki_98	reise motorrad]
terminologieverwaltungsmodule	[]
dienstanweisung	[]
sgbxi	[]
lockenwickler	[]
exzenterpresse	[]
wlan¿	[]
betriebsvereinbarung	[]
finanzbuchhaltungsprogramm	[]
autocad mechanical 2009	[src\main\resources\extractedWiki\CN/wiki_55	rabobank cycling team/saison 2009]
sps/cnc	[]
sd-modul	[]
cafm	[]
nivelliergerat	[]
rohrzange	[]
activ directory	[]
indesign	[]
laserschneideanlage	[]
microsoftprodukt	[]
waferinspektionssystem	[]
lotes	[]
ultraschallgerat	[]
weg-recht	[src\main\resources\extractedWiki\AA/wiki_00	abkürzungen/gesetze und recht]
klammerstapler	[]
gebührenrecht	[]
zygo-interferometer	[]
relational datenbank	[]
kantenanleimautomat	[]
netzwerkprotokoll	[]
hubarbeitsbühne	[]
power point	[src\main\resources\extractedWiki\BT/wiki_95	stony point (north carolina)]
sensor	[]
js-framework	[]
unix	[]
iptables	[]
fahrrad	[]
ms-office-tool	[]
out-look	[src\main\resources\extractedWiki\CN/wiki_54	hide-out-effekt]
beschichtungsroboter	[]
mega cad	[]
ror	[]
warenscanner	[]
altium	[]
ms-/power projekt	[]
simulink®	[]
contao	[]
phpbb	[]
3d-messmaschine	[]
xenapp	[]
rpg	[]
pro e	[src\main\resources\extractedWiki\BT/wiki_95	instituto de filosofia e ciências humanas]
propel/doctrine	[]
mofa	[]
vision tool	[]
zwangsvollstreckungsrecht	[]
baumaschinenbereich/agrar	[]
ms-office-modulen	[]
microsoft cloud produkt	[]
voice-over-ip	[]
it/netzwerke	[]
cad-glaser	[]
rammplan	[]
vertikaldrehmaschine	[]
csharp	[]
laserschneidmaschine	[]
telefon	[]
cad bad-software	[src\main\resources\extractedWiki\AT/wiki_98	sv germania bietigheim (bietigheim, baden), src\main\resources\extractedWiki\AM/wiki_02	business software alliance]
kurzdrehautomat	[]
leicht-omnibusse	[]
apm	[]
smtp.	[]
lötautomat	[]
ms access	[]
codesy	[]
grafikanwendung	[]
bedien-tableaus	[]
arcmap	[]
netweaver application server (as)	[src\main\resources\extractedWiki\AT/wiki_98	rich internet application]
uds-protokoll	[]
kranlanlage	[]
typo-script	[]
office-produktfamilie	[]
gaszug	[]
diagra	[]
hybris	[]
extj	[]
cnc-fräser/dreher	[]
gh bladed	[]
kleintransporter	[]
sharpoint	[]
jcl	[]
hochgeschwindigkeitszug	[]
vb6.	[]
heckenschneide	[]
web-programmiersprach	[src\main\resources\extractedWiki\CN/wiki_53	franz-weber-hof, src\main\resources\extractedWiki\AM/wiki_02	limbo (programmiersprache)]
kühl-/gefrierschrank	[]
webserver	[]
baustoffkran	[]
abkantbank	[]
chemikaliengesetz	[]
partdesign	[]
framemaker	[]
kommissionier-stapler	[]
lagerwirtschaftssystem	[]
selbstentladebulker	[]
amadeus/guideres	[]
cisco-netzwerke	[]
zeichnung	[]
lagerpaternoster	[]
asp	[]
serena dimensions	[]
e-wagen	[]
plancal	[]
jee	[]
sps-system	[src\main\resources\extractedWiki\BV/wiki_98	politisches system indiens]
rup	[]
bagger	[]
bauordnungsrecht	[]
mouse	[]
durchflusssensorik/-messtechnik	[]
datev.	[]
i-phone	[]
microsoft-office-paket	[]
flugzeugen	[]
diagnosewerkzeug	[]
netzwerkkamera	[]
fütterungsanlage	[]
msp-anlage	[]
hängerfahrzeug	[]
cad-programme	[src\main\resources\extractedWiki\CJ/wiki_99	liste der öffentlich-rechtlichen hd-programme in europa]
muldenfahrzeug	[]
cybelec-steuerung	[]
crs-systemen	[]
diagnosesoftware	[]
fernverkehrszug	[]
transfermaschine	[]
android	[]
sägeanlage	[]
multimeter	[]
datev-software	[src\main\resources\extractedWiki\AM/wiki_02	business software alliance]
verwaltungsrecht	[]
solidworks	[]
rüttelplatten	[]
cad-programmen	[src\main\resources\extractedWiki\CJ/wiki_99	liste der öffentlich-rechtlichen hd-programme in europa]
ava	[]
drahterodiermaschine	[]
buchhaltungsprogramm	[]
energieberatungssoftware	[]
winform	[]
java-programmierung	[]
verdichter	[]
cross-browser	[src\main\resources\extractedWiki\CN/wiki_55	southern-cross-expedition/mannschaftsliste]
boot	[src\main\resources\extractedWiki\CN/wiki_53	get on your boots]
llkw	[]
laserschweißanlage	[]
vollstreckungsrecht	[]
perpheriegerät	[]
x)html	[src\main\resources\extractedWiki\AT/wiki_99	histiozytose x]
montagebühnen	[]
webshpere	[]
kaltpresse	[]
oo-programmierung/	[]
schneideplotter	[]
laserschneide	[]
präferenzrecht	[]
hydropulsanlage	[]
hebebühne	[]
sap r/3 hr	[]
handlingsgerät	[]
gasbrenner	[]
flurfördergerät	[]
lern-managementsystemen	[]
plattensäge	[]
dosieranlage	[]
see-container	[src\main\resources\extractedWiki\AM/wiki_02	velden am wörther see]
cad/pdm	[]
straßenverkehrsordnung	[]
sprinter/ducato	[src\main\resources\extractedWiki\CN/wiki_55	super sprint]
hebebühnen	[]
robcat	[]
sqas	[]
robcad	[]
kartonverschliesser	[]
warenwirtschaftsprogammen	[]
kreditwesengesetz	[]
catia v5	[]
catia v4	[]
systemtelefon	[]
eisenbahnnebenfahrzeug	[]
feile	[]
catiav5	[]
breitbandkabel-anlage	[]
akkubohrer	[]
e-cad-system	[src\main\resources\extractedWiki\BV/wiki_98	politisches system indiens]
cat-tools	[]
betriebsanlage	[]
kommissioniergerät	[]
kraftfahrtzeug	[]
konturmessgerät	[]
buchungssoftware	[]
ldorado	[]
systemsoftware	[]
bluestar	[]
acrobat	[]
hplc-ms	[]
mobilfunk/festnetz/dsl	[]
ground-power-units	[]
pflegequalitätssicherungsgesetzt	[]
polierautomat	[]
r+i-schemata	[]
mehrachsenmaschine	[]
r-stab	[]
onlinerecht	[]
drehschemelanhänger	[]
cloud	[]
jms	[]
jmx	[]
ldap	[]
schutzausrüstung	[]
netzsimulationssoftware	[]
cangraph	[]
-maschinen	[]
3d-messtechnik	[]
bügelmeßschraube	[]
is-mam	[]
schwerlastmodul	[]
ms-office-paket	[]
datev-pro	[]
j"ee	[]
java-umfeld	[]
ablaufplan	[]
sps-programmen	[src\main\resources\extractedWiki\CJ/wiki_99	liste der öffentlich-rechtlichen hd-programme in europa]
cam-software	[src\main\resources\extractedWiki\AM/wiki_02	business software alliance]
ilustrator	[]
solaris/hp-ux	[]
ameise/hubwagen	[]
kaffeevollautomat	[]
bodenreinigungsmaschine	[]
bordcomputer	[]
cnc-gesteuert einspindel-drehautomat	[]
ava-anwendung	[]
itil	[]
poliermaschine	[]
vray	[]
r3-sd	[]
telekommunikationssystem	[]
switche	[]
brandschutzverordnung	[]
presswerkzeug	[]
hobel	[]
solid work	[]
schleifmaschine	[]
baumaschine	[]
zend-framework	[]
handkreissag	[]
knickarm-roboter	[]
barcode-scanner	[]
inventor	[]
jpa	[]
ms-project	[]
gewindeschneide	[]
betonmischer	[]
san	[src\main\resources\extractedWiki\BT/wiki_98	san colombano al lambro]
sap	[]
sas	[]
großrechner	[]
kran	[]
rtc-web	[src\main\resources\extractedWiki\CN/wiki_53	franz-weber-hof]
sensorsystem	[]
dynpros	[]
schreibware	[]
produktdatenmanagementsystem	[]
robotersoftware	[]
krad	[]
seitenschubstapler	[]
biegewerkzeugen	[]
schleifer	[]
portalanlage	[]
logikanalysator	[]
diagnose-gerät	[]
xp/200x	[]
simplorer	[]
canoe	[]
asterisk	[]
kettenförderer	[]
drehmaschine	[]
cnc-mehrspindelautomat	[]
tautliner	[]
uk gaap	[]
msc adams	[src\main\resources\extractedWiki\BT/wiki_95	johann adam ackermann]
kommunaltraktor	[]
produktions-roboter-maschine	[]
pflasterverlegemaschine	[]
entladekran	[]
programmiertool	[]
spritzroboter	[]
cinema	[]
scl	[]
schmiedepresse	[]
skizze	[]
cnc-langfräswerk	[]
krafträd	[]
.net-framework	[]
calypso	[]
mm/pp/ps	[]
mehrschalengreifer	[]
jsf	[]
photoshop/illustrator	[]
klebebind	[]
sandstrahlgerät	[]
freebsd	[]
jsp	[]
rexx	[]
autocad-mechanical	[]
lebensmittelrechtskenntnis	[]
siemens protool	[]
designpattern	[]
erp-system	[src\main\resources\extractedWiki\BV/wiki_98	politisches system indiens]
industrieroboter	[]
qt-framework	[]
iskv-anwendung	[]
vertikalstapler	[]
wasserwaage	[]
spannmittel	[]
java/jee	[]
schablon	[]
helpdesk-system	[src\main\resources\extractedWiki\BV/wiki_98	politisches system indiens]
datev-programmen	[src\main\resources\extractedWiki\CJ/wiki_99	liste der öffentlich-rechtlichen hd-programme in europa]
sew	[]
xfire	[]
zeitarbeitssoftware	[]
sql-programmierung	[]
zollrecht	[]
abas-fop	[]
icem-surf	[]
linux-anwendung	[]
beamer	[]
zerspanungsmaschine	[]
förderband	[]
lüftungsgerät	[]
telefonanschluß	[]
ultraschallschweißen	[]
microsoftprogramm	[]
spritzgussmaschine	[]
cad-plan	[]
ecm-lösung	[src\main\resources\extractedWiki\BT/wiki_98	lösung (betriebswirtschaft)]
folgeschnittwerkzeug	[]
mini-)bagger	[]
visi	[]
e-bikes	[]
kontrollsystem	[]
planning system	[src\main\resources\extractedWiki\BV/wiki_98	politisches system indiens]
offic	[]
achsvermessungsgerät	[]
zahnarztpraxissoftware	[]
stecheise	[]
sql-server-datenbank	[]
ms-exchang	[]
solo-lkw	[]
postgre	[]
stangenlader	[]
mikroskop	[]
powerpoint	[]
überwachungsgerät	[]
baunorm	[]
umts-notebook	[]
sgv	[]
becherpistole	[]
sap-entwicklungsumgebung	[]
kamerasysteme/fahrerassistenzsystem	[]
werkstattpressen	[]
frachtpapier	[]
fortinet/cisco	[]
bgb	[]
strahlmaschine	[]
dovecot	[]
walking-floor	[src\main\resources\extractedWiki\BV/wiki_97	floor-darlehen]
mazatrol	[]
spannfutter	[]
überseecontainer	[]
bgv	[]
word/excel/outlook	[]
fertigungsanlage	[]
prüfmaschine	[]
amadeus	[]
immobiliensteuerrecht	[]
requisitpro	[]
elaxy	[]
ms windows 2003/2008	[src\main\resources\extractedWiki\BT/wiki_97	dfb-hallenpokal der frauen 2008, src\main\resources\extractedWiki\BT/wiki_96	windows developer]
ständerbohrmaschine	[]
sage-produkt	[]
härtemessgerät	[]
audioeditor	[]
informix	[]
2d/3d-cad	[]
schwerlasttransport	[]
cproject	[]
php-frameworks	[]
vc++	[]
drehzelle	[]
sattelschlepper	[]
lagerverwaltungssystema	[]
stechbeitel	[]
dasylab	[]
lupe	[src\main\resources\extractedWiki\BT/wiki_98	lupe ontiveros]
fließband	[]
luftrecht	[]
fachzeitschrift	[]
verfahrensapparat	[]
großmaschine	[]
zeichnungsvorschrift	[]
abscheidevorrichtung	[]
modem	[src\main\resources\extractedWiki\AM/wiki_00	lolita-mode]
montagefahrzeug	[]
telefonanschluss	[]
c+/++	[]
scada-systemen	[]
sahneautomat	[]
cam-system	[src\main\resources\extractedWiki\BV/wiki_98	politisches system indiens]
messwandler	[]
cad¿programmen	[]
word/excel/powerpoint/project	[]
mr-tomographie	[]
handelsgesetzbuch	[]
zollrechtlich	[]
kaufrecht	[]
inter-/intranet	[]
ms.net	[]
breitbandanlage	[]
monitoringsystem	[]
ms-office-bereich	[]
kamm	[]
sicherheitsnorm	[]
tandemzug	[]
smb	[]
datenbank	[]
traktor	[]
ms-sql	[]
msp430	[]
buchhaltungssoftware	[]
vrv-anlagen	[]
messverstärker	[]
easy-vet	[]
gmp-regularien	[]
bpel	[]
macos	[]
druckmaschine	[]
3d-konstruktionssoftware	[]
erbrecht	[]
krankenhausinformationssystem	[]
videorekorder	[]
prüfplan	[]
mess-system	[src\main\resources\extractedWiki\BV/wiki_97	messe freiburg, src\main\resources\extractedWiki\BV/wiki_98	politisches system indiens]
c/al	[src\main\resources\extractedWiki\BT/wiki_98	san colombano al lambro]
entwicklungstool	[]
plansattelzug	[]
adabas	[]
php.	[]
soa	[]
php5	[]
heizkessel	[]
office	[]
turbomed	[]
airlessgerat	[]
schneidemaschine	[]
mikroprozessor	[]
modellierungstool	[]
vb-skript	[]
vba-programmierung	[]
aps-umgebung	[]
linux-server	[]
sap-netweaver	[]
cnc-schleifer	[]
sondermaschinen"	[]
spc	[]
solid-works	[]
photoshop	[]
steueranlage	[]
abrechnungsprogramm	[]
computergesteuert werkzeugmaschine	[]
incoterm	[]
sps	[]
debugging-tool	[]
datenloggersystem	[]
process-designer	[]
maschinene	[]
abkantpressen	[]
straßenfahrzeug	[]
mittelspannungsschaltanlage	[]
elektrohubwagen	[]
visual-studio	[src\main\resources\extractedWiki\BT/wiki_96	pulchri studio]
sql	[]
wdsl	[]
regiograph	[]
etax-lohnportal	[]
dosierautomat	[]
digitaldrucker	[]
sgb xi	[]
software-entwicklungswerkzeug	[src\main\resources\extractedWiki\AM/wiki_02	business software alliance]
catia/caa.	[]
dokumentationswerkzeug	[]
delphi	[]
sofistik	[]
40-tonnern	[]
rfem	[]
klein-lkw	[src\main\resources\extractedWiki\CN/wiki_55	stefan klein]
kopierer	[]
mitsubishi-maschine	[]
sap®-modul	[]
rundfunkgerät	[]
raupenbagger	[]
chromatgraphieauswertesystem	[]
adobe-photoshop	[]
laserschweiß	[]
kompressor	[]
mini-bagger	[]
caq-programm	[src\main\resources\extractedWiki\CJ/wiki_99	liste der öffentlich-rechtlichen hd-programme in europa]
staplerfahrzeug	[]
remotecapi	[]
sap-r3	[]
ssl	[]
stromrichter	[]
telekommunikationssystema	[]
bladed	[]
zend	[]
itaya/wafios	[]
produktionswerkzeug	[]
bestückungsautomat	[]
druckgussmaschine	[]
sozialvorschrift	[]
trassenplan	[]
ms-word	[]
apache-server	[]
840d	[]
greenhill multi	[]
pim-system	[src\main\resources\extractedWiki\BV/wiki_98	politisches system indiens, src\main\resources\extractedWiki\CJ/wiki_98	liste der biografien/pim]
kleintransport	[]
güterwagen	[]
amada-abkantpresse	[]
abholfahrzeug	[]
asphaltwalze	[]
,sql	[]
personenschutzartikel	[]
häcksler	[]
anwendungsserver	[]
html/css/xml/javascript	[src\main\resources\extractedWiki\BV/wiki_99	css-9]
raupenfahrzeug	[]
persis	[]
access	[]
jsp/servlet	[]
a380	[]
din-norm	[src\main\resources\extractedWiki\AT/wiki_98	europäische norm]
tankfahrzeuge	[]
containertransportfahrzeug	[]
portalkran	[]
hubschrauber	[]
forstmaschine	[]
ra-mic­ro	[]
ms dynamics nav	[]
netbeans	[]
postgres	[]
activemq	[]
gabelstapler/gültig	[]
hängerzug/wechselbrücke	[]
indutstrierobot	[]
positionierer	[]
depv	[]
svn	[]
nc-brennschneidemaschine	[]
brenner	[]
gartenwerkzeug	[]
gnu/unix	[]
kommissionierger<e4>t	[]
grafiksoftware	[]
datenbankserver	[]
lmhv	[]
tcl/tk	[]
kfz	[src\main\resources\extractedWiki\BV/wiki_98	kfz-kennzeichen (philippinen)]
microskasse	[]
bus	[src\main\resources\extractedWiki\CJ/wiki_99	de haan’s bus &amp; coach]
lokomotive	[]
sapscript	[]
ausführungszeichnung	[]
brennmaschine	[]
regelungsgerät	[]
laborutensillie	[]
honmaschine	[]
proenginer	[]
3d-modellierungsanwendung	[]
monitoringsoftware	[]
t-sql	[]
schwermaschine	[]
swt	[]
apache	[]
kreuzleger	[]
infrarotdetektor	[]
cinema4d	[]
lotus-notes	[src\main\resources\extractedWiki\CN/wiki_55	carl lotus becker]
brückenkrahn	[]
netzwerkanlage	[]
css2	[]
windows xp	[src\main\resources\extractedWiki\BT/wiki_96	windows developer]
css.	[src\main\resources\extractedWiki\BV/wiki_99	css-9]
palettenhubwagen	[]
öfen	[]
paisy	[]
sandstrahleinrichtung	[]
inbetween	[]
erp-systsem	[]
sap-mm	[]
microsoft-office	[]
spritzgußwerkzeug	[]
programmiersprache	[src\main\resources\extractedWiki\AM/wiki_02	limbo (programmiersprache)]
grafikverarbeitungsprogramm	[]
fem/mks	[]
css3	[]
theodolit	[]
mikroprozessortechnik	[]
c++/clr	[]
navigationssoftware	[]
heidenhainsteuerung	[]
,hecklader	[]
lkw`s	[]
perücke	[]
trennschneidanlage	[]
kis	[]
linienbuse	[]
,ajax	[]
,excel	[]
grafik-werkzeug	[]
hubwagen	[]
cat-tool	[]
5-achsfräsmaschinen	[]
sql-datenbank	[]
leergutrücknahmesystem	[]
grabenstampfer	[]
spring-framework	[]
handschleifen	[]
abap/4	[]
.net-entwicklungssprachen	[]
abfertigungsprogramm	[]
web-entwicklungstechnologie	[src\main\resources\extractedWiki\CN/wiki_53	franz-weber-hof]
appgat	[]
steinof	[]
sps-s5	[]
sps-s7	[src\main\resources\extractedWiki\AT/wiki_99	saleen s7]
database-server	[src\main\resources\extractedWiki\AT/wiki_99	compact disc database]
hallenkran	[]
spiral-ct	[]
navison	[]
warenwirtschaftssystem	[]
sap-hr	[]
versionierungssystem	[]
arcfm	[]
schüsselfräsmaschine	[]
wellenlötmaschine	[]
software-entwicklungstool	[src\main\resources\extractedWiki\AM/wiki_02	business software alliance]
viergabelstapler	[]
okuma	[]
s7-300/400	[src\main\resources\extractedWiki\BT/wiki_96	nash 400, src\main\resources\extractedWiki\AT/wiki_99	saleen s7]
magneto	[]
c/370	[src\main\resources\extractedWiki\CN/wiki_53	370. infanterie-division (wehrmacht)]
kopiergerät	[]
geoinformationssystem	[]
bo-cad	[]
koordinationsmessgerät	[]
materialförderanlage	[]
sps-siemens-steuerung	[]
grafik-programm	[src\main\resources\extractedWiki\CJ/wiki_99	liste der öffentlich-rechtlichen hd-programme in europa]
koordinatenmessgerät	[]
gastronomiespülmaschine	[]
gnu/gcc	[]
spitzendrehbank	[]
jdeveloper	[]
kalkulationsprogramm	[]
mysql 5	[src\main\resources\extractedWiki\BV/wiki_97	dongfeng 5]
content management system	[src\main\resources\extractedWiki\BV/wiki_98	politisches system indiens, src\main\resources\extractedWiki\BT/wiki_96	c3 creative code and content]
slicer	[]
schweißmaschine	[]
wohnwagen	[]
c167	[]
cnc-dreher	[]
cnc-schleifteilen	[]
kleinbaumaschine	[]
sap-fi	[src\main\resources\extractedWiki\BT/wiki_96	wi-fi protected setup]
wincc/wincc	[]
videoanlage	[]
abisolierwerkzeug	[]
autocad/e-schaltplän	[]
iso-draw	[src\main\resources\extractedWiki\AA/wiki_00	iso 4217]
zivilrecht	[]
heidenheim	[]
heidenhein	[]
gesenkbiegepresse	[]
myeclipse	[]
s7-steuerung	[src\main\resources\extractedWiki\AT/wiki_99	saleen s7]
raw-konverter	[]
lasermesssystem	[]
seitenschubmast*	[]
gravostyle	[]
php+mysql	[]
laborabfüllanlage	[]
flexodruck	[]
/openssl	[]
zentrifuge	[]
cnc-drehautomat	[]
3dsystemen	[]
cad-3d	[]
ava-programmen	[src\main\resources\extractedWiki\CJ/wiki_99	liste der öffentlich-rechtlichen hd-programme in europa]
sap ewm	[]
router	[]
windows-netzwerk	[src\main\resources\extractedWiki\BT/wiki_96	windows developer]
pressfahrzeug	[]
finanzbuchhaltungssoftware	[]
transporeon	[]
hr/hcm	[]
saugfahrzeug	[]
bildbearbeitungssoftware	[]
serverbetriebssystem	[]
pv-anlage	[]
feuerlöscher	[]
notebook	[]
wikisoftware	[]
matlab	[]
schere	[src\main\resources\extractedWiki\CJ/wiki_99	katrin scherer]
schneideanlage	[]
pflegegerät	[]
sanierungsfahrzeug	[]
it-helpdesk	[]
kaufvertragsrecht	[]
vba.	[]
pam crash	[]
teleskoplader	[]
sap-ep	[]
netzwerktechnik	[]
web-framework	[src\main\resources\extractedWiki\CN/wiki_53	franz-weber-hof]
frontmaststapler	[]
cad	[]
autokran	[]
kassensystem	[]
oberflächenmessgerat	[]
cam	[]
knetmaschine	[]
design-pattern	[]
caq	[]
leitungstabelle	[]
qualitätsrichtlinie	[]
flex	[]
cat	[]
cax	[]
tcl	[]
matlab®/simulink®	[]
ursprungsrecht	[]
tcp	[]
sap-bw	[]
homogenisierungsanlage	[]
schieblehre	[]
gasschweiß	[]
sap-co	[src\main\resources\extractedWiki\CJ/wiki_98	mpc münchmeyer petersen &amp; co.]
hämmer	[src\main\resources\extractedWiki\CJ/wiki_98	landtagswahlkreis hamm i]
treecad	[]
typo3	[]
bandsäge	[]
html/css/js/xml	[src\main\resources\extractedWiki\BV/wiki_99	css-9]
e-cad	[]
xpress	[src\main\resources\extractedWiki\AT/wiki_97	xpress]
